aly-mir156a	GGGUUGGUUGUGAGUGAAAGAGUUGGGACAAGAGAAACGCAAAGAAACUGACAGAAGAGAGUGAGCACACAAAGGCAAUUUGCAUAUCAUUGCAUUUGCUUCUCUUGCGUGCUCACUGCUCUUUCUGUCAGAUUCCGGUGCUGAUCUCUUUGGCCUGUCCUCGAUCUCUUUGUCUCAAUCUCUC	(((..(((..((((..(((((((((((((((((((...(((..(((.(((((((((((((((((((((.(((((((((..((((......)))).))))))...))).))))))))).))).))))))))).)))...)))...)))))......))))).))).))))))..))))))).))) 
aly-mir156b	AACAGAGAAAACUGACAGAAGAGAGUGAGCACAUGCAGGCUCUGUUAUGUGUCUAUAACUUUGCGUGUGCGUGCUCACCUCUCUUUCUGUCAGUUGCUUAUCUCUUGUU	((((((((.(((((((((((((((((((((((.((((.((...((((((....))))))...)).)))).))))))).))))).))))))))))).....)))).)))) 
aly-mir156c	GCAUAGAAACUGACAGAAGAGAGUGAGCACACAAAGGCACUUUGCAUGUUCGAUGCAUUUGCUUCUCUUGCGUGCUCACUGCUCUAUCUGUCAGAUUUCGGC	.....(((((((((((((((((((((((((.((((((((...(((((.....)))))..)))))...))).))))))))).)))).)))))))).))))... 
aly-mir156d	AUGGGGGAAAAGAAGUUGACAGAAGAGAGUGAGCACACAAAGGGGAAGUUGUAUAGAAUUUUUGUAUAUGGUUGCUUUUGCGUGCUCACUCUCUUUCUGUCAUAACUUCUCCUUUCAU	(((((((...((((((((((((((((((((((((((.((((((.((...((((((((...))))))))...)).)))))).)))))))))))).))))))))..)))))).))))))) 
aly-mir156e	GUAGAGUGUGAAAGGUAAGAGGAGGUGACAGAAGAGAGUGAGCACACAUGGUGGUUUCUUGCAUGCUUUUUUUUAAUUAGGGCUUCAUGCUUGAAGCUAUGUGUGCUUACUCUCUCUCUGUCACCCCUUCUCUCUCUCUUUUCAAAUUAC	....(((.(((((((..(((((((((((((((((((((((((((((((((((...(((..(((((((((.........)))))...))))..))))))))))))))))))))))).)))))))))...)).))))..))))))).))).. 
aly-mir156f	GUAUGUGAUAUUAAGAGGUAUAUAUGAAUCAUAAAUAUGGAUGGUUUGAUUGAUGAGUAAUUGAUGGUGACAGAAGAGAGUGAGCACACAUGGUGGCUUUCUUGCAUAUUUGAUGGUUUCAUGCUUGAAGCUAUGUGUGCUCACUCUCUAUCUGUCACCCCCUUCUCUCUCUCUAUAUACACCAUUUAAAUUUAUUUUAUAGAGUUAUAUACAAUUUGAUUUUGAUAC	(((((((((.............((((((..((((((.((((((((...((.((.(((.....(..(((((((((((((((((((((((((((((....(((..(((....(((.....))))))..))))))))))))))))))))))).)))))))))..)......))))).))....)))))))).))))))))))))..)))))))))................ 
aly-mir156g	GGAGGUAAGUGAUGAAUAACAAUAAGGAAGGCGACAGAAGAGAGUGAGCACACAUGGCUCCUUUUUCUAGCAUGCUCAUGCUCGAAAGCUCUGCGUGCUUACUCUCUUCUUGUCUCCUCCUGCUUUCUCUCUUUCUCU	(((((.(((.((.(((........((((.((.(((((((((((((((((((.((.((((.....(((.(((((....))))).))))))).)).))))))))))))))).)))).))))))...))))).)))))))) 
aly-mir156h	GAAAUGUUGACAGAAGAAAGAGAGCACAACCUGGGAUUAGCAAAAAGAUAGUUUUGCCCUUGUCGGGAGUGUGCUCUCUUUCCUUCUGCCACCAUCAUC	...(((.((.((((((((((((((((((.(((((.(...((((((......))))))...).)))))..)))))))))))).)))))).)).))).... 
aly-mir157a	GAGGCAUUGAGAGUGUUGACAGAAGAUAGAGAGCACAGAUGAUAAGAUACAAUUCGGAGCAGUUUCUUUGCAUCUUACUCCUUUGUGCUCUCUAGCCUUCUGUCAUCACCUUUUAUUUGCUUU	((((((.((((((((.(((((((((.(((((((((((((.((((((((.(((...((((....))))))).)))))).)).)))))))))))))..))))))))).)).))))))..)))))) 
aly-mir157b	GUGUUGACAGAAGAUAGAGAGCACAGAUGAGAAGAUACAAUUCUUCGCAGCUUCUUUGCAUCUUACUCCUUUGUGCUCUCUAAGCUUCUGUCAUCAC	(((.(((((((((.(((((((((((((.((((((((.(((...............))).))))).))).)))))))))))))..))))))))).))) 
aly-mir157c	CAUACUUUAUGAUGUUGCAUAUAUCACACAUACGUUUGAGAGUGAUGCUGGUUGUUGACAGAAGAUAGAGAGCACUAAGGAUGACAUGCAAGCACAUACAUAUAUCAUCACACCCCAUGUGGAUGAUAAAAUAUGUAUAACAAAUUCAAGAAAGAGAGAGAGAGAGAGAUCAGAUGUAGAGGGAGAGGGAGAGAAAGAGACUGCAUCUCUACUCUUUUGUGCUCUCUAUACUUCUGUCACCACCUUUAUUUCUUCUUCUCUCUCACCUACAUAUACGCACAGUCACAUCUAUG	.........((((..(((.(((((.........(((((...((.((.(((((.(((..(........)..)))))).)).)).))...)))))..((((((((((((((.(((.....))))))))))...)))))))...............(((((((((.((((((((((((((((((((...(((((((..(((((.....))))).)))))))...)))))))))..))))...........))))))).)))))))))......))))).)))..))))........ 
aly-mir157d	AUGUUGUAUGUAUAGUGGAGGGUGAUAGUGUGGUUGCUGACAGAAGAUAGAGAGCACUAAGGAUGAUAUGCAAAACACACACAUAUAUGUGCUUCUAAUUGUAUUUCAUACUUAACAUCAAUGUUGAUGUGAAUCGUGAAAAAAAAAAAAGAGAGAAGAGCUAGAGGAGCAUCUGCAUCUCUAUUCCUAUGUGCUCUCUAUGCUUCUGUCAUCACCUUUUUUUCUCUAUUUCUCUCUACACAUUACAUAUUCACAU	((((.(((((((..((((((((.(((((...(((.(.((((((((((((((((((((..((((....((((((......((((....)))).......))))))(((((.....((((((....)))))).....))))).........(((((..((((((.....))).)))...)))))..))))..))))))))))).))))))))).)))).........))))).))))))))....)))))))..)))) 
aly-mir158a	ACGUCAUCUCUGUGCUUCUUUGUCUACAAUUUUGGAAAAAGUGGUGACGCCAUUGCUCUUUCCCAAAUGUAGACAAAGCAAUACCGUGAUGACGU	((((((((.(.(((...(((((((((((.(((.(((((.(((((((....))))))).))))).))))))))))))))...))).).)))))))) 
aly-mir158b	UCAGAAGAAUAGUAACUCGUCAUCUCUGUGCCUCUUUGUCUACAAUUUUGGAAAAAGUAGUGUCGCCAUUGUUUUUUUCCCAAAUGUAGACAAAGCGAUACCGUGAUGACGUUAUAGAGAUUUUGUUUGA	((((((((((.......(((((((.(.(((.(.(((((((((((.(((.((((((((.((((....))))..)))))))).)))))))))))))).).))).).)))))))........))))).))))) 
aly-mir159a	GAGAAAAAAAAAGAUGGAAGUAGAGCUCCUUGAAGUUCAAACGAGAGUUGAGCAGGGUAAAGAAAAGCUGCUAAGCUAUGGAUCCCAUAAGCCCUAAUCCUUAUAAAGAAAAAAAAGGAUUUGGUUAUAUGGCUUGCAUAUCUCAGGAGCUUUAACUUGCCCUUUAAUGGCUUUUACUCUUCUUUGGAUUGAAGGGAGCUCUACAUCUUCUUUCACCUUCUC	(((((....(((((.(((.((((((((((((..((((((((.((((((.(((((((((((...((((((.((.((.((((.(..(((((((((..(((((((............))))))).)))).)))))..).)))).)).)).))))))...)))))))......))))..)))))).))))))))..)))))))))))).))))))))....))))) 
aly-mir159b	GGAAGAAGAAGAGGAAGAGCUCCUUGAAGUUCAAUGGAGGGUUUAGCAGGGUAAAGUAAAGCUGCUAAGCUAUGGAUCCCAUAAACCUUAUCAAAUUCAAAAUAAGGAUUUUUUAUGGAUUCCAUAUCUCAGGAGCUUUCACUUACCCCUUUAAUGGCUUCACUCUUCUUUGGAUUGAAGGGAGCUCUUCAUCUCUACCUCC	(((.(.(((.((.((((((((((((..(((((((.(((((((..(((((((..((((((((((.((.((.((((((..(((((((((((((..........))))))....)))))))..)))))).)).)).)))))).))))..))))......)))..))))))).)))))))..)))))))))))).))))).).))) 
aly-mir159c	AGAAGGAGCUCCCUUCCUCCAAAACGAGGAGGACAAGAUUUGAGGAACUAAAAAGCAAAAUCUAAGAGUUCAUGGAUUCCUCAUAGAGAGUGCGUAGGUUAACAUCUUGAAGAAAGCACACUUUAAGGGGACUGCAUGACCUCUUAGAUUAUCUCUCUCUCUCUCUCUCUCUCUAUACAUCCUUCUCUUCUCUUCGUUUGGAUUGAAGGGAGCUCCUUUU	.(((((((((((((((.((((((.((((((((...(((...(((((.((....))...((((((((((.(((((.(.(((((.(((((.((((.....((((....)))).....)))).))))).))))).).))))).)))))))))).............................))))).)))))))))))))))))..))))))))))))))). 
aly-mir160a	CGCCUAUACAUGUAUAUAGAUGUAUAUGUAUUAUAUAUGUAUGCCUGGCUCCCUGUAUGCCAUAUGCUGAGCUCAUCGAGUAUCGAUGACCUCCGUGGAUGGCGUAUGAGGAGCCAUGCAUAUCCUCAUACAUAUAUAUACAUAAUUAUGUGAUGGUG	((((..((((((.......((((((((((((.......((((((.(((((((.((((((((((..((.(((.(((((((...))))))).))).))..)))))))))).))))))).))))))....)))))))))))).......))))))..)))) 
aly-mir160b	UAUAUAUAGAUUUAAGGUCGUGCCUGGCUCCCUGUAUGCCACAAGAAAACAUCGAUUUAGUUACAAAAUCGAUCACUAGUGGCGUACAGAGUAGUCAAGCAUGACCAAAGCUUUCUUGAUAUAUA	(((((..(((.....((((((((.((((((.(((((((((((.((.....((((((((.......))))))))..)).))))))))))).).))))).)))))))).......)))..))))).. 
aly-mir160c	CAUAUAAUAGUUUGUCGUCGUUAUGCCUGGCUCCCUGUAUGCCACGAGUGGAUACCGAUUUUGUUAUAAAAUCGGCUGCCGGUGGCGUACAAGGAGCCAAGCAUGACCAUAAGCAUAUG	.........((((((.(..(((((((.(((((((.((((((((((..((((...(((((((((...)))))))))))))..)))))))))).))))))).))))))))))))))..... 
aly-mir161	GAUCAAUGCAUUGAAAGUGACUACAUCGGGGUUUUGUUUUUUUGUUGCUCCCACGAUCGAAUCGAUAUGAGGAAGAUGAAAAAUUAAUCAACCCCGGUUUAGUCACUUUCACUGCAUUAAUC	(((.((((((.((((((((((((.((((((((((((.(((((((((..(((((..((((...)))).)).))).))))))))).)))..))))))))).)))))))))))).)))))).))) 
aly-mir162a	GAUUCGGGAAAUUUUAUGUUUCUUUGCCAUUUUUUUUGGAGUUUAGUUGGAAAAAGAGUGAGAGUCGCUGGAGGCAGCGGUUCAUCGAUCUCUUCCUGGGAACGAAUAUAUAAAUAUUGAAAAAGCAUGAAUAGAUCGAUAAACCUCUGCAUCCAGCGUUUGCCUCUUUAUCUUUGUUAUUGGCUUCAAUUUUUUUGGUUUUUGAAAAAAGUGAGGGAAAACAGAGUC	(((((......((((((.((((...((((......((((((((.....(((.((((((.(.(((.(((((((.((((.((((.((((((((.(((.((......(((((....))))).......)).))).)))))))).)))).)))).)))))))))).))))))).)))........))))))))......))))....))))...)))))).......))))) 
aly-mir162b	UUUUUUUAGUUCUCUCCUCAUUUUUAUGUUUGGAUUUAGAGUGAAGUCGCUGGAGGCAGCGGUUCAUCGAUCAAUUCCUGUGAAUAUUUUUGUUUUCAAAAGCAUGAAUCGAUCGAUAAACCUCUGCAUCCAGCGCUUACUCUUCCUCAUCUGUUUAAUAAUCUAUUUGAGAAUGCUCAAAAGA	((((((.(((..((((.......((((...(((((..(((((((.(.(((((((.((((.((((.(((((((.((((.(((......(((((....)))))))).)))).))))))).)))).)))).))))))))))))))).....)))))....)))).......))))..))).)))))) 
aly-mir163	GUGGGAGACAAGUACCUUCGAGAAACCGGCCAAAACCCGGUGGAUAAAAUCGAGUUCCAGCCUCCUCAGAGACUUUAGCAACAACGAUUUCAACACUCUCUUACAGGAACUUCCUCCAGGCAGAAGAUACUGUCUUGCGAAGUUCCGGGUUCCUUCUUCGUCCGUGAGUCAUGAUCAAGAUACGCUUUCUUGACCACAUGGUUGAACCAGUGCAAUGCAUGUUGCUGUUCCACAUGGGAGAGUCGCGGUUUUUGAUCCCUUUGGGGAUUUUGGAGGUGAAAUGGAACGCGUAAUUGAUGACUCCUAUGUGGAAACUCUUAUGUCGAAGAAGGAACCGCGAUUUUGCUAAUCCAAGUGCUUAAAUCGUUGAGGCUGAAGUCGUUGAAGAGGACUUGGAACUCGAUCUUAUCCACCGCGUUUUAUCCGGUUUCUCUGUGGGUUGUGAAAUAUUUUAU	.......(((...((((.(((((((((((..(((((.((((((((((.((((((((((((((((.((((.(((((((((..(((((((((...((((........((((((((....((((((......))))))...)))))))).(((((((((((((..((((((...((.((((((.......)))))).))..((((...))))..(((((....)))))..(((((((((((((.(((((((((((...(((((((((.....))))))).))...))))).)))....)))..)))))))))))))...)))))).)))))))))))))(((....))).......))))...)))))))))..))))))))).)))).)))).).))))))))))).)))))))))).)))))..)))))))))).).)))))))............ 
aly-mir164a	GUUGGAGAAGCAGGGCACGUGCAAACCAACAAACACGAAAUCCGUCUCAUGUGUUUUGCACGUACUCCCCUUCUCCAAC	((((((((((..(((.(((((((((.((......(((.....)))......)).))))))))).)))..)))))))))) 
aly-mir164b	GAUGGAGAAGCAGGGCACGUGCAUUACUAGCUCAUCUCGUAUGCAUAUAUAUAUACAUCCUCACCACAAAUGCGUGUAUAUGUGCGGAGAUAUAGAUAUAUAUGUGUGUGGAGUGUGAUGAUAUAAAUGAGUUAGUUCUUCAUGUGCCCAUCUUCACCAUC	(((((.((((..(((((((((....(((((((((((((.(((((((((((((((.....(((..((((.(((....))).))))..)))......)))))))))))))))))).............))))))))))....)))))))))..)))).))))) 
aly-mir164c	GGGUGAGUAACACUUGAUGGAGAAGCAGGGCACGUGCGAACACAAAUGAGAUCGAUCGGUACAUGAUGAUCAUAUUUUCGCACGUGUUCUACUCCUCCAACACGUGUCUCUCCCC	(((.(((..((((.((.(((((.((.((((((((((((((....((((.((((.((((.....)))))))).)))))))))))))))))).)).))))).)).))))..)))))) 
aly-mir165a	AUCAUGAGAAUUAAGCUAUUUCAGUUGAGGGGAAUGUUGUCUGGAUCGAGGAUAUUAUACAUAUAUACAUGUGUAUGUUGAUACAUGUGAUCAUAGAGAGUAUCCUCGGACCAGGCUUCAUCCCCCCCAACAUGUUAUUGCCUCUGAU	((((.(((......((.((..((((((.((((.(((..((((((.(((((((((((.........(((((((((......))))))))).........))))))))))).))))))..))).)))).)))).))..)).))))))))) 
aly-mir165b	GUGAAGAGGCCAUUUCCGUUGUGGGGAAUGUUGUUUGGAUCGAGGAUAUCAUAAAGGCAUACACAUGCAUUUAUAUGUUAUGAUGCAUUAUAUGAUUGUGUAAUGUACUUAUGUACAUAUAUAUAGAUGGUAAUGGUAUCGUCGGACCAGGCUUCAUCCCCCUCAACAUGUUAAGUGCCUUCAAUCAC	((((.(((((.((((..((((.((((.(((..((((((.((((.((((((((.......(((.(((..((.((((((((((((((((((((((....)))))))))).))))).))))))).))..)))))))))))))).)))).))))))..))).)))).)))).....)))))))))...)))) 
aly-mir166a	GGGGUUUUCUCUUUUGAGGGGAAUGUUGUCUGGCUCGAGGACUCUGGCUCGCUCUAUUCAUGUUGGAUCUUUUUCGAUCUAAUAAUCGAAUUGAACCUCCAGAUUUCAGAUCUGACUAGGGUUUUAGCGUCGUCGGACCAGGCUUCAUUCCCCCCAAUUGUUGCUCC	(((((.....(..(((.((((((((..((((((.((((.(((.((((...(((((((((.(((((((((......)))))))))...))).........((((((...))))))..)))))).)))).))).)))).))))))..)))))))).)))..)..))))) 
aly-mir166b	AGAGGGAUUUUUCUUUUGAGGGGACUGUUGUCUGGCUCGAGGUCUCUUAUUCUAAUACAAUCUCAUUUCAAUAGUCUCAGAUCUGAUGAUUGAUUAGGGUUUUAGCAUCUCGGACCAGGCUUCAUUCCCCCCAAUUAUUACUCCCUCU	(((((((........(((.(((((.((..((((((.(((((((((...((((((((.((((((((..((..........))..))).)))))))))))))...)).))))))).))))))..)).))))).))).......))))))) 
aly-mir166c	GGUUGAGAGGAAUGUUGUCUGGCUCGAGGUCAUGAAGGAGAGGAUAUCACUCCAAUUAAUUUGGAAGAACGAAUUAAGAAACCCUAAAUGAUUCUCGGACCAGGCUUCAUUCCCCCUAACC	(((((.(.((((((..((((((.((((((((((..(((...(((......)))..((((((((......)))))))).....)))..)))).)))))).))))))..)))))).).))))) 
aly-mir166d	GGUUGAGAGGAAUGUUGUCUGGCUCGAGGUCAUGAAGAAGAUCAUUAGAUUGAUUCAUCUUAAAGAAUGAAAACCCUAAAUGAUUCUCGGACCAGGCUUCAUUCCCCCCAACC	(((((.(.((((((..((((((.((((((((((..((....(((((((((......)))).....))))).....))..)))).)))))).))))))..)))))).).))))) 
aly-mir166e	GAGUCCAUGUUCUUCAGUGAAGCUUUUUCUUUUGAGGGGAAUGUUGUCUGGCACGAGGCCCUUAACUUAGAUCUAUAUUUGAUUUUAUGUCUCUUCUUUAUUUAUUAGUCUAUAUAUACAUGAAUGAUCGAUUUUAACGGUUAAUGACGUCGGACCAGGCUUCAUUCCCCUCAAUUAUAUCGCUUCUUCGAUCUUGGCUU	(((.(((.(.((......(((((........((((((((((((..((((((..(((.(.(.((((((...........((((((((((((...........................))))))..)))))).......)))))).).).)))..))))))..)))))))))))).......)))))...)).).)))))) 
aly-mir166f	AAGUUCAGGUGAAUGAUGCCUGGCUCGAGACCAUUCCAUCUCAUGAUCAUGAUGAUGAUAUAAUGAUGAUGAUGAUGUCGGACCAGGCUUCAUUCCCCUCAACUU	(((((.(((.((((((.((((((.((((.(.(((..((((((((.(((((....)))))...)))).))))))).).)))).)))))).)))))).))).))))) 
aly-mir166g	GGAAGCGAUUUAGGGUUUAGAGGAAUGUUGUUUGGCUCGAGGUCAUGGAGAGUAAUUCGUUACCAAAACACAAAACUCUAAAUGAUUCUCGGACCAGGCUUCAUUCCCCUCAACCUAUUUUAUCGCAUUUU	....(((((...(((((.((.((((((..((((((.((((((((((..(((((.....(((.....))).....)))))..)))).)))))).))))))..)))))).)).))))).....)))))..... 
aly-mir166h	AAGUUCAGGUGAAUGAUGCCUGGCUCGAGACCAUUCCAUCUCAUGAUCAUGAUGAUGAUAUAAUGAUGAUGAUGAUGUCGGACCAGGCUUCAUUCCCCUCAACUU	(((((.(((.((((((.((((((.((((.(.(((..((((((((.(((((....)))))...)))).))))))).).)))).)))))).)))))).))).))))) 
aly-mir167a	GGUGCACCGGCAUCUGAUGAAGCUGCCAGCAUGAUCUAAUUAGCUUUCUUUAUAUCUGUUGUUGUGUUUCAUAACGAUGGUUAAGAGAUGAGUCUCGAUUAGAUCAUGUUCGCAGUUUCACCCGUUGACUGUCGCACC	(((((..(((((.(.(.(((((((((.((((((((((((((((((((((((.((.(((((((((((...))))))))))).))))))).))).)).)))))))))))))).))))))))).).).)).)))..))))) 
aly-mir167b	AUCUGCACAACUUGUUGCUCAGGUAUUUUGAAGACAAGUCCACAAGGGAACAAGUGAAGCUGCCAGCAUGAUCUAUCUUUGGUUAAGAGAUGAAUGUGUAAACAUAUUGCUUAAACCCAAGCUAGGUCAUGCUCUGACAGCCUCACUCCUUCCUGGUUUAGGACCAUUCACUGAUAAAGCAUUCCACAUGCCGAU	(((.(((.....((((..((((......((((.....((((((..(((((..(((((.(((((.(((((((((((.(((.(((((((.(((..((((....))))))).))).)))).))).)))))))))))..).)))).)))))..))))).))...))))..))))))))...)))).......))).))) 
aly-mir167c	CAGUAGCAGUUAAGCUGCCAGCAUGAUCUUGUCUUCCUCUCUUAAGUUUCAUAUAUAAUCAAGUUAAUAUAAAGAUUUUGUACAAUUCUUGUUCUUAUUAUAUGAUCAUAGCUUAGAGAGAGAGAGACUAGGUCAUGCUGGUAGUUUCACCUGCUAAUG	...((((((..((((((((((((((((((.(((((.((((((((((((((((((((((.((((....((((((...)))))).....))))...))).)))))))....))))).))))))).))))).))))))))))))))))))...))))))... 
aly-mir167d	GAUCUAUAUCUAUGCUGGUUUUUAGAGGCUGAAGCUGCCAGCAUGAUCUGGUAAUUGCUACAUACGACAUACACACAUAUACUAGUUAAUUUCCACACCUAUAAAAGUUUUUUUCCUACAACUUAAAGCUUUUUUCCUUCCUCUUUUUAAUAAUUAGUGAUCUCUAGUUCUUUGCCUACUUGUAAUAUAUAUUUACGGUGGAUUCAUGCAUGUGUGUAUAUAUAUACAUAGUUUACAUGCAUGCAUUUUGUGUAUGUGUGUGUGUAUAGAUAGUAGUACUAGGUCAUCCUGCAGCUUCAGUCACUAAAUCACCAACAAUAUCAAAUC	............((.((((.(((((.((((((((((((.((.(((((((((((.((((((..((..((((((((((((((((..(((((.............(((((((((.............))))))))).............)))))((((((......))))))......(((((.((((.......)))))))))....(((((((((((((..(((....)))...)))))))))))))...)))))))))))))))).))..))))))))))))))))).)))))))))))))).)))))..)))).)).......... 
aly-mir168a	GAGUCUCACCGUCGGGCUCGGAUUCGCUUGGUGCAGGUCGGGAACCAAUUCGGCUGACACAGCCUCGUGACUUUAAAACCUUUAUUGGUUUGUGAGCAGGGAUUGGAUCCCGCCUUGCAUCAACUGAAUCGGAUCCCCGAGGUGUAAGAAAACUC	((((((((((.(((((.((.((((((.((((((((((.(((((.((((((((((((...)))))...((.(((..(((((......)))))..))))).))))))).))))).)))))))))).)))))).))..)))))))))..)))...))) 
aly-mir168b	AGAGAGAAAUACGAUGAUUUAAAGUUACCGGCGGUCUCGGAUUCGCUUGGUGCAGGUCGGGAACUGAUUAGCUGACAAUUACACGUGUGUUGUCAUGGUUGGUUUGUGAGAUCCCGUCUUGUAUCAACUGAAUCGGAGUCCGAGGUGAAAAAAAUAAGGAUCUUACUUUCAGAUCU	.(((((..........((((....(((((..(((.(((.((((((.((((((((((.(((((((.((((((((((((((.((....))))))))..)))))))).))....))))).)))))))))).)))))).))).))).)))))...))))..........)))))...... 
aly-mir169a	AACGCGUAUGUGACGAAAGUAGUGUGCAGCCAAGGAUGACUUGCCGAUUUAAAUGAUCUUUCUUUAUACUCUAUUAAGACAUUUUAAGUUUCAAAUUUCUUUGGUUCUUCAAGGAUUAAGGAAGAAAGUAGGCUAUAUAUGUAGAUAUAUAUAUUAUGCUGUAUUAAAUAUAUGUACAAGAUAAGACCAAAAAAGAAAAAGUAACAAUCAUGAUCGGCAAGUUGUCCUUGGCUACACGUUACUUUGUGUCGCGCAUAGGUGUU	(((((.((((((.(((((((((((((.((((((((((((((((((((((...(((((.(((((((....(((....))).......(.((((....((((((((((((...)))))))))))))))).).((((.(((.((((.((((((((((......))))...)))))).))))..))))).))...)))))))........))))))))))))))))))))))))))).))))))))))....))))))))).))))) 
aly-mir169b	GUGCCCAACGGAGUAGAAUUGCAUGAAGUGGAGUAGAGUAUAAUGCAGCCAAGGAUGACUUGCCGGAACGUUGUUAAUCAUACGUAUAAAUUAUGUGAUGAACAUAUUUCUGGCAAGUUGUCCUUCGGCUACAUUUUGCUCUCUUCUUCUCAUGCAAACUCUCUUUGGGAUAU	...(((((.((((.((..((((((((...((((.((((((.((((.((((((((((((((((((((((...((((.(((..(((((.....)))))))).))))...)))))))))))))))))).)))).)))).))))))))))...)))))))).))))))))))).... 
aly-mir169c	GUCUCAUCUAAAGCCUUGAAUGUGGGAAAAAGGCCAUUGUUGUUCAGCCAAGGAUGACUUGCCGGUAGCUUUGUAUAUUUACUCUAUAUUCGGUUUAUAUUAUGGAGAUUAUGCUUUAUAUAUAUAUAUACAUAGUUUUAAUUGAUUUUUUUUCGUACGUACGUAAUCUAAUACGAAAAAGUAUUUACUUAUUUAUAUGUGUGUUGGUGAGAUGUGUAAACAAAGCAAGCCCGGCAAGUCAUCUCUGGCUAUGCAACUGCCUCUUCCUCUCAUUCUAGGCUUACGAUGACAC	((.(((((..((((((.(((((.(((((..((((....(((((..(((((.((((((((((((((..(((((((.......(((((((............))))))).((((((.((.(((....(((((((((....(((..(((.((((((((((..............)))))))))).)))...)))....)))))))))..))).)).)))))))))))))....)))))))))))))).)))))..))))).)))).)))))..))))).))))))..))))).)) 
aly-mir169d	GUAUCUUUGAGUCUUACAUGGAAAAAAUAGAGAAUGAGAUUGAGCCAAGGAUGACUUGCCGAUUUUUAUCAACAAAUCUUAACUGAUUAUGGUGCCCGGCAAGUUGACCUUGGCUCUGUUUCCUUCUCUUCUUUUCGAUGUCAAACUCUAGAUAU	((((((..((((...((((.(((((...((((((.(((((.(((((((((..(((((((((.....(((((...((((......)))).)))))..)))))))))..))))))))).))))).))))))..))))).))))...)))).)))))) 
aly-mir169e	GUCACUAAUUGUAUCAUAGAGUCUUGCAUGGAAAAAAUAGAGAAUGAGAUUGAGCCAAGGAUGACUUGCCGAAUUUAUUAACAAAUCUCAAAUGAUUAUGGUGCCCGGCAAGUUGACCUUGGCUCUGUUUCCUUCUCUUCUUUUCGAUGUCAAACUCUAGAUAUAUCAAUCGAU	(((......((((((.((((((.((((((.(((((...((((((.(((((.(((((((((..(((((((((....(((((...((((......)))).)))))..)))))))))..))))))))).))))).))))))..))))).))).)))))))))))))))......))) 
aly-mir169f	UGUAUCAGAGGGUCUUGCAUGAAGGAAUAAAGAAUGGAAUUGAGCCAAGGAUGACUUGCCGGUUUAAACACAACCGGAUUAUGACCAUUGAUUUGGUCUCAUUCACAAUCUGUUGAUUCGUGUCUGGCAAGUUGACCUUGGCUCUGCUUCGUUCUCUAUUCUUCCAUGUUAGAUUCCAGAUAUA	((((((.(.((((((.(((((.(((((((.((((((((...(((((((((..((((((((((........((((.(((((..(((((......)))))........)))))))))........))))))))))..)))))))))...)))))))).))))))).))))).))))))).)))))) 
aly-mir169g	AUGAUGAUGAUGAGUCUCUAGUUGUAUCAGAGGGUCUUGCAUGGAAGAGUAGAGAAUGAGGUUGAGCCAAGGAUGACUUGCCGGGUUUUUUACCAAUGAAUCUUAACUGAUUUUGGUGUCCGGCAAGUUGACCUUGGCUCUGUUUCCUUCUCUUCUUUUCGAUGUCAGACUCCGCGAUAUAUAUCUAUUUCAUCAUCGUCAU	((((((((((((((........((((((.(.((((((.((((.((((((.((((((.((((..(((((((((..(((((((((((.....(((((..(((((......)))))))))))))))))))))..)))))))))..)))).)))))).)))))).)))).)))))))..)))))).......)))))))))))))) 
aly-mir169h	UAGAAAAUCAUAUAAGAGAAAAUGGUGACAUGAAGAAUGAGAACUUGUGUGGUAGCCAAGGAUGACUUGCCUGCGUUUUAACAAUACAAUAUCAAAGACUACUCGAUCGAUCGAUAGUCUUAGAGUUGGUUAGUCGUCAGGCAGUCUCCUUGGCUAUUCAAACAAUUCUUGUUCUCCUCAUUUCACAUCUCUCUUUCGUUUUUUG	((((((((.....((((((.....((((.((((((((((((((.((((.(((((((((((((.((((.(((((((..(((((....((((.((.(((((((.((((....))))))))))).))))))))))).)).))))))))))))))))))).))).))))))))))))))..)))).))))...))))))..)))))))) 
aly-mir169i	GAAGGAGAUGUCAAAGAUGAGUAGGAGAAUCAUAUUUGGUAGCCAAGGAUGACUUGCCUGAUUCCUUUGCGUAAAAUGGUUAGUGUCAUGUUUGACAAAGUGACUAUCAAUUACAUCAAGCGAUGACCAUUUUGCUUAUAAAAAAGAUGUCAGGCAGUCUCCUUGGAUAUCCUUAUAUGUUCUUCUCUUUCAUCUCAGACAUUCAUCUUC	(((((.((((((..(((((((.(((((((.(((((..((...(((((((.((((.(((((((..((((..(((((((((((...(((..((((((.....(((...)))......)))))))))))))))))))).......))))..))))))))))))))))))....))..))))))))))))..)))))))..)))).)).))))) 
aly-mir169j	GAAUGAGGCAAAACAUAUUGAGUAAUGGAGUGUAUAAUGAGGAAGAGAGGUCUAACAUGGCGAAAAGAGUCAUGUUUAAUAGCCAAGGAUGACUUGCCUGAUCUUUUUCACCUCCAUGAUUCAAUUUGAAGUUCAUGCGUUUUGGAUUAUUAUGCAUCUAAAAGGUAUAAUAAUUCGAAAAUCAUGUUGAAUCAUGCGGGUUAGGUUUCAGGCAGUCUCCUUGGCUAUCUUGACAUGCUUUUUUCAUCCAUGUUAUACCUGUUUUUCUUUCUGUCUCUAAAGUCACUAUUAAGUCUCUUC	(((.(((((.....(((.(((.(..(((((...(((..((((((((.((((.((((((((.((((((((.((((((..(((((((((((.((((.((((((....(((.((((.((((((((((.........((((..((((((((((((((((.........))))))))))))))))..)))))))))))))).)))).)))..)))))))))))))))))))))...))))))))))))))..)))))))).)))).))))))))..)))))))).).))).)))...)))))))) 
aly-mir169k	GAAGGAGAUGUCAAAGAUGAAUAAGAGAACCACAUUUGGUAGCCAAGGAUGACUUGCCUGUUUCUUUGAACAAAAUGGUUGGUGUCAUGUUUGAUGUGACUACAAGUUAUAUCAAGAAUGACAUUUUGCUUAUAAAAAGACAUCAGGCAGUCUCCUUGGCUAUCCUUAUAUGUUCUUCUUUCUCAUCUCAGACAUUUACCUUC	((((((((((((..((((((..((((((((.......((((((((((((.((((.(((((..(((((.........(((.((((((((.((((((((((((...)))))))))))).))))))))..))).....)))))...))))))))))))))))))))).......)))).))))..))))))..))))))).))))) 
aly-mir169l	GUUAAGAAAUGUAUGAUGAAGAUGAGAGGUCUAACAUGGCGAAAAGAGUCAUGUUUAAUAGCCAAGGAUGACUUGCCUGAUCUUUUUCACCUCCAUGAUUCAAUUUGAAUUUCAUGGGUUUUGGAUUAUUAUGCAUCUAAAAGGUGUAAUAAUUCGAAAAUCAAGUUGAAUCUUGCGGGUUAGGUUUCAGGCAGUCUCCUUGGCUAUCUUGACAUACUCUUUUCAUCCAUGUUAUACCUAAUUUUCUUUUUUUAUUGAGGAUAUUUGAGGAU	......((((((..((((((((.(((((((.((((((((.(((((((((.(((((..(((((((((((.((((.((((((....(((.((((.((.((((((((((((.((((.........(((((((..(((((((...)))))))))))))))))).)))))))))))).)).)))).)))..)))))))))))))))))))))...))))))))))))))..)))))))).))))....)))..))))))))....))))))...... 
aly-mir169m	UCAUUAUUUAGAAGGAAAUGUCAAAGAUGAAUAGGAGAAUCAUAUUUGGUAGCCAAGGAUGACUUGCCUGUUUCUUUGAGUAAAAUGGUUAUUGUCAUGUUUGACAAGUGACUAUAAGUUAUAUCAAGUAACGACCAUUUUACUCAUCAAAAGACAUGAGGCAGUCUUCUUGGCUAUCCUUAUAUGUUCUUCUGUCUCAUCUCAGACGUUAACCUUCAUCUAAAAUAAGA	..........(((((.((((((..(((((((((((((((.(((((..((((((((((((.((((.((((...((((((((((((((((((.((((((....))))))((((((...))))))..........))))))))))))))....))))....)))))))))))))))))).))..)))))))))))))).))))))..))))))..)))))............. 
aly-mir169n	GAAGUGUAUAACGAGGAAAAGAGGUCUAACAUGGCGAAAAGAGUCAUGUUUAGUAGCCAAAGAUGACUUGCCUGAUCUUUUUCACCUCCAUGAUUCAAUUUGAAUUCCAUGGGUUUUGGAUUAUUAUGCAUUUUAAAAGCAUAAUAGUUCGAAAAUCAUGUUGAAUCUUGCGGGUUAGGUUUCAGGCAGUCUCUUUGGCUAUCUUGACAUGCUUUUUUCAUUCAUGUUAUACCUAUUUUUCUUUCUGUCUUC	((((...(((..((((((((.((((.((((((((.((((((((.((((((.((((((((((((.((((.((((((....(((.((((.((.(((((((.........(((((.((((((((((((((((.........)))))))))))))))).)))))))))))).)).)))).)))..)))))))))))))))))))).)).))))))))))))))..)))))))).)))).))))))))..))))))) 
aly-mir170	CAUUCUCUCUCUUCGAUUCUUGUUUCUCUUGCAAAACAGAUACCCUCUGUCUCUGAGUCCGAGAGAGUCCCUCUGAUAUUGGCCUGGUUCACUCAGAUUCUCCUAACUAACUCAUCUGAUUGAGCCGUGUCAAUAUCUCAGUCCUCUCUCGUCGCUUCUCUCAUACUUUAGAGAUUGUUUUGUUUUGUACACACGAGUUGUUUGUUGAUAUG	.....((......((((((.(((......(((((((((((((..(((((....((((..((((((((...((..(((((((((.(((((((.((((((...............)))))).))))))).)))))))))..))..))))))))........)))).....)))))..)).))))))))))).))).))))))......)).... 
aly-mir171a	UCGUUUUUUAUAUUGUUUUCCUUUGAUCUAUCACUUAAGCACGAGAGAGUCCCUUUGAUAUUGGCCUGGUUCACUCAGAUCUUCCCUGACCACACUCACGUCGUACAUAUGCAUUCUCUCUAGAUUAUCUGAUUGAGCCGCGCCAAUAUCUCAGUACUCUCUCGUCUCUAUUUUGGACUUUGUGAUCUUGUAAAUCGA	(((...((((((..(((.......(.((((.......((.((((((((((..((..(((((((((.(((((((.((((((..((...(((.........)))(((....)))..........))..)))))).))))))).)))))))))..)).))))))))))))......))))).....)))..)))))).))) 
aly-mir171b	GAGUGAUUUUAUGUAAGGUAACGCGAGAUAUUAGUGCGGUUCAAUCAAAUAGUCGUCCUCUUAACUCAUGGAGAUCGGUGUUGUUCGAUUGAGCCGUGCCAAUAUCACGCGGUAAACCAAAAUGGCAAAGAUCGAUC	((.(((((((.(((..(((..((((.((((((.(((((((((((((.((((((((..((((........))))..)))..))))).))))))))))))).)))))).))))....)))......)))))))))).)) 
aly-mir171c	GGACAUCGAAUACGAGAUAUUGGUGCGGUUCAAUCAGAAAACUGUACUCUUUUGUUUUAAAGAUCGGUUUGUUUGAUUGAGCCGUGCCAAUAUCACGUGUUUAAAUAGUUU	.......(((((((.(((((((((((((((((((((((((((((...(((((......))))).)))))).))))))))))))))))))))))).)))))))......... 
aly-mir172a	GGAGCCACGGUCGCUGUUUGCUGCUGUGGCAUCAUCAAGAUUCACAUCUGUUGAUGGACGGUGGUGAUUCGCUCUCCCCAAAGUUCUCUAUGAAAAUGAGAAUCUUGAUGAUGCUGCAUCGGCAAUCAACGGCUAUUCUUUUUCUCUCC	((((....(((((.((.((((((.(((((((((((((((((((.(((.(((.((.((((..(((.((.......)).)))..)))))).)))...))).))))))))))))))))))).)))))).)).)))))...........)))) 
aly-mir172b	UAGCUCAUCUGUCGUUGUUUGUAGGUGCAGCACCAUCAAGAUUCACAUGAAAAUUGAUAAAUCUCCUAAAUUAGGGUUUUGAUAUGUAUAUGAGAAUCUUGAUGAUGCUGCAUCAACAAUCGACGGCUACAAAAUACCUAAAGCUG	(((((.....(((((((.((((.(((((((((.(((((((((((.((((.....((.((((.(.((((...))))).)))).))....)))).))))))))))).))))))))).)))).)))))))..............))))) 
aly-mir172c	AGCUACUGUUCGCUGUUGGAGCAUCAUCAAGAUUCACAAAUCAUCAAGUAUUCGUGUAAAUGAACCCAUUUAUAAUUAUAUUGUUGAUGUAUGUAUGAGAAUCUUGAUGAUGCUGCAGCUGCAAUCAGUGGCU	((((((((...((.((((.(((((((((((((((((((...((((((((((...((((((((....))))))))...))))..))))))..)))....)))))))))))))))).)))).))...)))))))) 
aly-mir172d	GAUUCAGAAUUUGAAGUUAGUGGCAGUCAUUGUUUGCUAUUGCAACAUCUUCAAGAUUCAGAAAUCAGAUUCUUUUAUGGGUUUUCUUUUGAGCCUAUAUUAUUUGGUUUGAGAAUCUUGAUGAUGCUGCAGCGGCAAUUAAAUGGCUUAUUUAUCUAGGGUU	..((((.....)))).(((((((.(((((((..(((((.(((((.((((.(((((((((..(((((((((.....(((((((((......)))))))))..)))))))))..))))))))).)))).))))).)))))...)))))))...))).)))).... 
aly-mir172e	GCCAGUAGUCGCAGAUGCAGCACCAUUAAGAUUCACAAGAGAUGUGGUUCCCUUUGUUUUUGCCUCUCGAUCCGAAGAAAAGGGUUCCUUUCGAGUGGGAAUCUUGAUGAUGCUGCAUCAGCAAAUACAUGGC	(((((((...((.(((((((((.(((((((((((.((...((...((..((((((.((((((..........))))))))))))..))..))...)).))))))))))).))))))))).))...))).)))) 
aly-mir172f	AGCUACUGUUCGCUGUUGGAGCAUCAUCAAGAUUCACAAAUCAUCAAGUAUUCGUGUAAAUGAACCCAUUUAUAAUUAUAUUGUUGAUGUAUGUAUGAGAAUCUUGAUGAUGCUGCAGCUGCAAUCAGUGGCU	((((((((...((.((((.(((((((((((((((((((...((((((((((...((((((((....))))))))...))))..))))))..)))....)))))))))))))))).)))).))...)))))))) 
aly-mir173a	GGUGACUAAGUACUUUCGCUUGCAGAGAGAAAUCACAGUGGUCAAAAGUUAAAGUCUCUUUCCUCUGUGAUUCUCUGUGCAAGUGGAAGAGCUUGCUCCC	((.((.(((((.((((((((((((.((((((.((((((.((...((((.........)))))).)))))))))))).)))))))))))).))))).)))) 
aly-mir173b	GGUGACUAAGUACUUUCGCUUGCAGAGAGAAAUCACAGUGGUCAAAAGUUAAAGUCUCUUUCCUCUGUGAUUCUCUGUGCAAGUGGAAGAGCUUGCUCCC	((.((.(((((.((((((((((((.((((((.((((((.((...((((.........)))))).)))))))))))).)))))))))))).))))).)))) 
aly-mir1887	UUGUUCACUUAGAUUGUUCUUAGUAUGAGUUGUUCUCGUACUAAGUAGAGUCUAAGAGAACAA	.(((((.((((((((.(.(((((((((((.....))))))))))).).)))))))).))))). 
aly-mir2111a	GUAUUGGUGAGGAUCGGGUAAUCUGCAUCCUGAGGUUUAAAGCUUAAUUUAAGCAGAAAAUUUGUAUACGCAUAUACGUAUGUGUGUUGGUAUAGCUUUUAGUCCUCGGGAUGCGGAUUACCUCUUCCUUACUUACAAUAC	(((((((((((((..((((((((((((((((((((...((((((........(((((...)))))(((((((((....)))))))))......))))))....))))))))))))))))))))..)))))))...)))))) 
aly-mir2111b	GUACUUGGUGAUGAACGGGUAAUCUGCAUCCUGAGGUUUAAAACUUUAUAAGCAUUUACGUAUGUGACUAUAUAGUUUUUUUAAUCCUCGGGAUACAGAUUACCUCUUCCUUACUCGAAGUAC	(((((((((((.(((.((((((((((.(((((((((.((((((((.((((..(((........)))..)))).)))...))))).))))))))).)))))))))).))).)))))..)))))) 
aly-mir2111c	GUAUUGGUGAGGAUCGGGUAAUCUGCAUCCUGAGGUUUAAAGCUUAAUUUAAGCAGAAAAUUUGUAUACGCAUAUACGUAUGUGUGUUGGUAUAGCUUUUAGUCCUCGGGAUGCGGAUUACCUCUUCCUUACUUACAAUAC	(((((((((((((..((((((((((((((((((((...((((((........(((((...)))))(((((((((....)))))))))......))))))....))))))))))))))))))))..)))))))...)))))) 
aly-mir2112	AUGAUGCGCAAAUGCGGAUAUCAAUGUAAAUCAGGACAACAAACCAAUAGAGGUGCUCAGCAAAAACAACAAAAUGCGAAAAGGGUUUAUCAGAAACAUUAUUUGAAACAUUGGGGUCAUGAUAUACCUUUAUAUCCGCAUUUGCGCAUCAU	(((((((((((((((((((((.((.(((.((((.(((..((((((......)))((...))..........((((.(.....).)))).(((((.......)))))....)))..))).)))).))).)).))))))))))))))))))))) 
aly-mir319a	GGAUGUUGUAGGAAUAUAUAUGUAGAGAGAGCUUCCUUGAGUCCAUUCACAGGUCGUGAUAUGAUCCAAUUAGCUUCCGACUCAUUCAUCCAAAUACCGAGUCGCCAAAAUUCGAACUAGACUCGUUAAAUGAAUGAAUGAUGCGGUAGACAAAUUGGAUCAUUGAUUCUCUUUGAUUGGACUGAAGGGAGCUCCCUCUCUCUUCUGUAUUCCAAUUGUCU	((((...((.((((((((...(.(((((((((((((((.((((((.(((.(((..((.(.(((((((((((.(((.(((..((((((((.((..((.((((((................)))))).))..)).))))))))..))).)).).)))))))))))).))..))).))).)))))).))))))))))..))))))...)))))))).)).)))) 
aly-mir319b	AAAUGUUAAUAUGGUUAUAGAUGUUGAGUUGGUGAAGGAAGAGAGCUUUCUUCGGUCCACUCAUGGAGUAAUAUGUGAGAUUUAAUUGACUCUCGACUCAUUCAUCCAAAUACCAAAUGAAAGAACAUGUUCUCAUAUGGUAAAUGAAUGAAUGAUGCGAGAGACAAAUUGAGUCUUCACUUCUCUAUGCUUGGACUGAAGGGAGCUCCCUAUUUUUAUUUUUUCUCGGUCGUACACAUUUCAUUU	(((((.....(((..(((.(((..((((..((((((((.((.(((((((((((((((((..(((((((......(((((((((((((..((((((..((((((((.((..(((((.((((..(((....))))))).)))))..)).))))))))..))))))...))))))))).))))..)))))))..))))))))))))))))).)).))))))))....))))))))))..)))..))))) 
aly-mir319c	AUAGAUAAAUAUAUGAAUCGAGAUUAAAAUAGAUAGAUAUAGAAGGAGAUUCUUUCAGUCCAGUCAUGGAUAGAAAAAGAAGAGGGUAGAAAUAUCUGCCGACUCAUCCAUCCAAACACUCGUGGUAGAGAAACGAUCAAUUUUAAACCGCAGUGACUGUAUGAAUGAUGCGGGAGAUAUUUUUGAUCCUUCUUUAUCUGUGUUUGGACUGAAGGGAGCUCCUUCUUUUUCUACAAUUUUUUCAUUUUUUUCUCAUUACCUGUUUAUAUAU	........((((((((((.((((..(((((.((((((...((((((((.((((((((((((((.((((((((....((((((.((.(((((((((((.(((..((((.(((.((..((((.(((((..((((........))))..)))))))))..)).))).))))..))).))))))))))).)))))))))))))))).)))))))))))))).))))))))...))))........)))))))..)))).......)))))))))) 
aly-mir319d	AUAGAUAGAUAUAUGAAUCGAGAUUAAAAUAGAUAGAUAUAGAAGGAGAUUCUUUCAGUCCAGUCAUGGAUAGAAAAAGAAGAGGGUAGAAAUAUCUGCCGACUCAUCCAUCCAAACACUCGUGGUAGAGAAACGAUCAAUUUUAAACCGCAGUGACUGUAUGAAUGAUGCGGGAGAUAUUUUUGAUCCUUCUUUAUCUGUGUUUGGACUGAAGGGAGCUCCUUCUUUUUCUACAAUUUUUUCAUUUUUUUCUCAUCAUCUGUUUAU	(((((((((....(((...((((..(((((.((((((...((((((((.((((((((((((((.((((((((....((((((.((.(((((((((((.(((..((((.(((.((..((((.(((((..((((........))))..)))))))))..)).))).))))..))).))))))))))).)))))))))))))))).)))))))))))))).))))))))...))))........)))))))..)))).)))))))))))) 
aly-mir3433	UGAAUAAAAUGACUUAAACUGCGGUUACGUGGUCAUUUGAGAACUGUGAUGAGUAUACAAUGGUUUUUAUGCUCACGACAAUUUUCAAAGCAUCUCUAUGUUUAUGCUCAUCACAGUUCUUGAUUACCCACUAAACCGAUGUUUAAAAAACCUUUAUGUUUA	.............((((((..(((((..((((....(((((((((((((((((((((..((((.....(((((...((......))..)))))..))))...)))))))))))))))))))))....))))..)))))..))))))................ 
aly-mir3434	GCGGAUAACACCUUAAGGAAGGAUUGUUUUUGUUUUAUAGGUUAACUGUGGUGGUAAAUUUUAGCACUCGGCUGAUUCUCUGAUUUUGAACAGGGCUUCCUUAAGUCAGAUCAUUGGUCUCUCUCUCAAGUAACUUAGGGUUUGAAAAACAGCUUCUCCAGUCAGCAUCUUACCCUGCUCCUCAACACUCAGCAAAUCCACAAAUAGAAACGAGUCGUUGCUUCGGAAAGCCUUGUUCAAAAUCAGAGAAUCAACCAAGUGAUAAAAUUUACCACCACAGUUAACCUAUAAAACAAAAACAAUCCUUCCUUAAGUUGUUGUUGC	(((.((((((.((((((((((((((((((((((((((((((((((((((((((((((((((((.((((.((.((((((((((((((((((((((((((((...((..(((((...)))))..))...........((((((..((......(((.....))).....))..)))))).....((((((((.....................)))).))))....)).)))))))))))))))))))))))))).)).)))).)))))))))))))))))))))))))))))))))))))))))))))))))))).))))))))) 
aly-mir3435	AUUUUGAACAUUCAUUCUACUGUGAACAGAGCUCACCAAUUCUUGAACUGAUAACUAUUCUUUGACUUGGACUGCUGAUUUUGGCAUAAUUCUGUCAAUUCCCUCAUAGAUGUAAUGUAAGUUGGUUUGGAGUUCAGUAAAGAAGCAGUGACACUAAAUGACGGUUGGAAUGCCAGAGAUAGUCUAGUUACAUGUUUGAAGGAAUUGACAGUAUUAUGCCAGACGGCAUUUCAAGUUGAAGAGGAUGAAGAGCUCAAAGAUUGGUGAGGCCUGUUUAUGGCGAUGAAAUUGGCCUACAAAGU	((((((..((((((((...((((((((((..((((((((((.((((.((........((((((((((((((.(((((..(((((((((((.(((((((((((.(((.(.(((((((.........(((((.((((...........(((...)))............)))).))))).........))))))).).))).))))))))))).)))))))))))))))).)))))))))))))).......)).)))).))))))))))..)))))))))).))))))..)).....)))))) 
aly-mir3436	AAAAUUAUGUUUUCAAGCGAGCAAAAAUCAUUGUUGAUUUUGAAAAAGGUUUUAAGGUUACCGGUUCUGUUUGUUUGUUAUCCUUUUAAGAUCAACAACGAUUUUUGGGUCGUUUAAAAGUAUAAUUUU	(((((((((((((.((((((.((((((((.((((((((((((((..(((...((((...((.......))...))))....))))))))))))))))).))))))))..)))))).))))))))))))) 
aly-mir3437	GCAUAAUAUUGCCUGACAAAAAACAAGGAUCCACGGAUUUAGGAAUGGGAACGUUCUCUGUGUCCCAGAGCACAUUCUGCAAAACAAGUGUGCUUUGGGACACCGAGAAGGUUCCCAUUCCAAAAUCGGUGGAUCUUGUUUUUUGUCAGGCAAUAUUAUGC	(((((((((((((((((((((((((((.((((((.(((((.(((((((((((.(((((.(((((((((((((((((.((.....))))))))))))))))))).))))).))))))))))).))))).))))))))))))))))))))))))))))))))) 
aly-mir3438	CGAGUUUGUCGGAUCGAUCUAUUUUAACUCGGGUAAGCUAGAUUUCAUUCGUUUUGUUUCACCAAUCACAAGUUAUCGUUUAUGCUCCAUAGCUUCAUCUCUGACCCAAGAUCUUGUUUAUGCAUAAUUUUUUAUUUUACAACAAAAUCAUGAGUCAAGGAUUAAGCUAUGAAGCUUAAACAUAACUUGUAUUUGUUCUACAUAAUUUGCGUUUGAUUUGGAUCUAGAGGCCUUUUAAUCAAUAUCUUGUCUUUACAUAUUUCG	((((((....(((....))).....))))))(((...((((((((((..(((..(((.....(((..(((((((((.(((((.(((.((((((((.((((.((((.((.(((.(((((.....((((....)))).....))))).))).)).)))).)))).)))))))).))).))))))))))))))..)))....)))......)))..)))....)))))))..)))................................ 
aly-mir3439	GUGUAAAAUCCUUGUUUUCGCGGUUUAGCUAAACAGUAAACGUAAACCGAUGUUUUAAUUUUGGGGUUUCGAAAUCAAGAGGUCGACCAAACCGAUGAUAUGUCAUCUUAAAGCUAAGAGACUAUUAAUAGUGUCUUAAAAACACUAAAUCCUCGUUUGUAUAUCCAUUGGCUCGCAUACGGCAAAAUCAUACACAAUAACCUGCGUGCUUCUAUUGAGACUCUGAAUAAUCAUGUUCUUUGUCAGAUGUGCCCACUAAAACAAUUAAGUGUGAUGGUGUUGAUUUGGUCGACCUUCUGAUUUUCGAAGUCCCAAAAUCUAAACUCAUGUUUAUGUUUAAUGUUUAGUAGCCACGAGGACAAGGGUUCUACAC	(((((.((((((((((((((.((((..((((((((.(((((((((((.((.((((..((((((((((((((((((((.(((((((((((((.((((((((.(((.(((((....))))))))))))).((((((.......))))))...........(((((((....(((.((((...((..................)))))).)))((....))(((...(((((....)))))...))).))))))).(((((..(((......)))..)))))))).))))))))))))).))).)))))))))))))))))..))))))..))))))))))).)))))))))))).)))))))))))))).))))) 
aly-mir3440	GUUUGAUAUUAAUACUAACAUCAAAAGUAGAUUGCUUGCCAUUUGGUUAGGAAUUGGUCUGCGGCAUUUUCCACAAGUGUGGUUUCCCUGGCCAAUCCACUUGUAAUGUGUAUUUUGUAAAUAACGCAAAAUGUGCAUUAGAAGUGGAUUGGUCAAGAGAACCGCACUUGUGCAAAAUACCGCAGUCCAAUUUCUGACAAAAUGACAAGCAAUCCAUUUUGGAUGGCUUGUCUGUAUCGAGC	(((((((((..(((....((((.(((((.(((((((((.(((((.((((((((((((.((((((.(((((.((((((((((((((.(.((((((((((((((.(((((((((((((((.......))))))))))))))).)))))))))))))).).)))))))))))))).))))).)))))).)))))))))))).))))).))))))))).))))).))))...)))..))))))))) 
aly-mir3441	GUAGUUUUUGAUCUUCAGCGAAGAAAAUGAAGUCGUUUUGCUUCAAAGCAUCUUUGAAGGAAGGGAAAGUUACCAACUAACGUUUAGUAGCUACUCAAGCAUUAUUGACUUCACUCAUAGGAGUGGAACUAGGAUAUGAAUGCUUUCUAUGAGUUUGUGAAGAAAGCAAUUAGUUUUGGUGCUACUAAACGUCAAUUGGUAACUUUCACUUCCCUCAAUGAUGUUUUGAAGCAAAACGACUUCAUCUUCUUUGCUGAAGAUCAUAAACUAC	(((((((.(((((((((((((((((.((((((((((((((((((((((((((.((((.(((((.((((((((((((...((((((((((((...((((......)))).(((((((....)))))))((((((((.(((.((((((((............)))))))).)))))))))))))))))))))))...)))))))))))).))))).)))).)))))))))))))))))))))))))).))))))))))))))))).))))))) 
aly-mir3442	AGACUGAAAUUUUACAUUUUUAUACUAAACACCAUGUUUAGACUCUGAAUUUUUUCCAUAUAAUUUUAUUUUAAAAGGCAAAGACUUUUUUCCUAAAUCGGUCUCAAGGACUUAUUUAUUAUAUGGAAAAAAAUUCAGAGUCUAAACAUGGUGUUUAGUAUAAAAAUGUAAAAUUUCAGUCU	((((((((((((((((((((((((((((((((((((((((((((((((((((((((((((((((...........(((.((((....)))))))((((.(((((...))))).))))))))))))).))))))))))))))))))))))))))))))))))))))))))))))))))))))) 
aly-mir3443	AAUUUGGCUAAUCAGCAAAACUAAAUUCUAAUCCCGCCAUGCACCGAAAAAAUUCUAGACUGAAAUAAUACAGUCUGUGGUUUUCCGGUGCCUUGUGAGAUUAGAGUUUUAUCUUGUGAAUUUGCUUAAGGAGUU	.....(((.(((..((((....(((((((((((.(((...((((((..((((((.(((((((........))))))).)))))).))))))...))).)))))))))))....))))..))).)))......... 
aly-mir3444a	UAUGUAUCCUUUGUAAUCUCUUUAUAUUGGGAGCUCGAUGAGAUCGACCCUAACCGAGCCUAGAUAUCGAGAUUUGGUUCGGGUCAAUCUCAUCAAUCUCCCAAUACUUUACAACAUAUAUA	(((((((...((((((........(((((((((...((((((((.(((((.(((((((.((........)).))))))).))))).))))))))...)))))))))..)))))).))))))) 
aly-mir3444b	UUGAAUCCAAAUUCCAAACUAUUGGGAGAUUGAUGAGAUCGACCGACACCAAAUCAAGAUCAAUGAAGAUUACGAUUCCGUUUCGGUCAUCUCAUCAAUCUCCCAAUACGAACCUAAACCGAAAUUUUC	...................((((((((((((((((((((.((((((.((..((((..((((......))))..))))..)).))))))))))))))))))))))))))..................... 
aly-mir3445	AUGGUGGUAAAAUUUGAUAAUUGUCACCGACGGGUGGGUCUUUCUCCCUAUCAAGCGAACCAUCACCUUCCAAACCGUUCCCUUCUUCUUCGUGUGGGAGAGUAGUCCUAAGUAGCCAAAAGAAGAAGAAGGGCACAACUCCAAGGGUUUGGAAGGUGAUUGUUUGCUUGAUAGUGAGAAAGACCCACCCAUUGGUGAUAAUGAGAAAGACGCAGACAU	...(((......(((....(((((((((((.(((((((((((((((.(((((((((((((.(((((((((((((((.((((((((((((((...(((((......)))))...........)))))))))))).........)).))))))))))))))).))))))))))))).))))))))))))))).)))))))))))...)))..)))...... 
aly-mir3446	CUCCUAUCGUCCAAUAGUUUUUUUGGAAAGGCUUCAUUUAAACAGAGAGUCGUUUUAUCCUGGGAACUCACUCCAUCGUGAAUACUCGGAAGCUAGACGUGUGGCAGGGAAAAUGAGUUAAGGGAAACCGUGAUUAGUAUGACAUCGCCAACCGGCAGCAUUCACAAAGAUCUUAAACUCCUUUCCCCUGCCACUCUUUUAGCUUCCGAAUCUUUUUCGAUGGGUGAGUUCCUUGGAGAAAAAAUCUUUCUCUACGGAUGAAGCGUUUACGAAGAAACAAUUGGGAUGGAG	((((.(((..(((((.(((((((((..((.(((((((((....((((((...((((.(((.((((((((((.((((((.(((...((((((((((((.(.(((((((((.(((.(((((((((......((((.....(((.(...(((....))).)))))))).....)))).))))).))).))))))))).).))))))))))))....))).)))))))))))))))).))).))))...))))))....))))))))).))..))))))))).)))))))))))) 
aly-mir3447	GUUCAGAGACUGAUUCGUGACGAACAUAAUCAAACGAUGAAACCAUUUUAAGCUCAUCGAGAGAUUUCCUUAAAAUUGUCUCGUUGUUUGAGUGUGUUUGUUAUGAAUAAGACUCUGAAC	((((((((.((.((((((((((((((((.(((((((((((.((.((((((((...(((....)))...)))))))).)).))))))))))).)))))))))))))))).)).)))))))) 
aly-mir3448	UAUUGACCAGGAAAACAUCUUCAGACACGAGCUUGUCAGUCAAUUCCCAGACUUGACUUGACACAAACUCAUGUCUGAGGAUUUUUUUUGUGGUCAAUA	(((((((((.(((((.(((((((((((.(((..((((((((((.((...)).))))).)))))....))).)))))))))))..))))).))))))))) 
aly-mir3449	CUUUUAGUUUUCAUUCUGAGAUCCAAUAUCUAGAUUGCUUUCGGUCUGUCUGAUUGUCAGAUUAAUAAUAUGUUUGGUCAAAGUUUCAACCAAUCAGACAGAUAGAAAGCAAUCUGGAUAUUGGAUCUCAGAAUGAAAAUGACCAGAG	((....((((((((((((((((((((((((((((((((((((.(((((((((((((...((((((........))))))...........))))))))))))).))))))))))))))))))))))))))))))))))))....)).. 
aly-mir390a	CCAAAAAACAAGUAGAGAAGAAUCUGUAAAGCUCAGGAGGGAUAGCGCCAUGAUGAUCUUAUUUCAUAUCGAUUUUUUGGCGCUAUCCAUCCUGAGUUUCAUUGGCUCUUCUUACUACAAUGUAAAAGG	.......(((.((((((((((.((.((.((((((((((.(((((((((((....((((............))))...))))))))))).)))))))))).)).)).))))))..))))..)))...... 
aly-mir390b	AGUAGAAAAAUAGCUAUAAAGCUCAGGAGGGAUAGCGCCAUGAAUCACCAAUACUGUAGGUUUUGUAUAUACAUGCAUGUAGAUCUGUUGGCGCUAUCCAUCCUGAGUUCCAUAGCUUCUUCUUGCU	(((((((....((((((..(((((((((.(((((((((((...(((.....(((((((.((.........)).)))).))))))....))))))))))).)))))))))..))))))..))).)))) 
aly-mir391	GCAAACAAAGAUUUGCUUCGCAGGAGAGAUAGCGCCACCACCUCUUCUAAGAAGUUAACCAGUGGUGACGGUAUCUCUCCUACGUAGCAAUCCUUAUAUAUGC	(((....(((..(((((.((.((((((((((.((.((((((..((((...)))).......)))))).)).)))))))))).)).)))))..))).....))) 
aly-mir393a	AGCAACUAGAGGAAGGAUCCAAAGGGAUCGCAUUGAUCCUAAUAAAGGUGAAUUACCCCAAUCUUUUCUUAAUAAUUAGCAAACAAAUCAAAAAAAUUUGCUUGGUUUUGGAUCAUGCUAUCUCUUUGGAUUCAUCCUUCGGUAGCU	(((.(((.(((((.((((((((((((((.((((.(((((......(((((((((..........(((((........)).)))...........)))))))))......))))))))).)))))))))))))).))))).))).))) 
aly-mir393b	AGCAACUAGAGAAAGCAUCCAAAGGGAUCGCAUUGAUCCUAAUUAAGCUGAUUUAUUCCCCAAUAUUUUAUUUUCCUCAUUCGAAAGUUGGAGAAAAAAAAAAAAAAUUCUAAACAUUUGCUUUCUUUUCCGGAUCAUGCGAUCUCUUUGGAUUCAUUCUUUGGUAGCU	(((.(((((((((.(.(((((((((((((((((.(((((.....((((((.((((..........((((.((((((.............)))))).))))..........))))))...))))........)))))))))))))))))))))).).))))))))).))) 
aly-mir394a	UAGAUUGGAUCUUUAAACUUUUGUUCCUUUUCAUGAGGGUUUGACAAAGAGUUUCUUACAGACAUCUUUGGCAUUCUGUCCACCUCCUCCUGUACAUGUGUGUAUAUAUAUGUGUUUUGUGUGGAAGAAGGAGGUGGGUAUACUGCCAAUAGAGAUCUGUUAGGGUUUCUUCGUAAAACCCUCUUGAUCUAUAUACAACUUUAUCAAUGUCUUGAAUCUG	((((((((((..........((((......(((.((((((((.((.(((((.((((.(((((..(((((((((...((((((((((((.((..(((((((((....)))))))))..........)).))))))))))))...)))))).)))..))))).)))).))))).)).)))))))).))).......))))..........))))..)))))) 
aly-mir394b	GAUCAUGCGGGUUUGACAAAAGAGUCUCUUACAGAGAUCUUUGGCAUUCUGUCCACCUCCUCUCUCUAUAUGUAUAUGUAUGAGCGCUGUCUUGUGAGGGGAGGUGGACAUAUUGCCAACAGAGAUCUGUUAGGGUUUCUUUGUAAAACCCCUCAUGAUU	(((((((.((((((.(((((.(((.((((.(((((..(((((((((...((((((((((((((((((((((....))))).)))(((......)))))))))))))))))...)))))).)))..))))).)))).)))))))).))))))..))))))) 
aly-mir395b	GCCAAAUGUCCCCAUGAGUUCCCUUUAACGCUUCAUUGUUAAAUACUCAAAGCCACAUUGGUUUGUAUAUAACACUGAAGUGUUUGGGGGGACUCUUGGUGCCAUUUUGGC	((((((((.(.(((.((((((((((.(((((((((.(((((.((((...((((((...)))))))))).))))).))))))))).)))))))))).))).).)).)))))) 
aly-mir395c	AUGACAGAGCUACAAGAAGAAAGUCAAAUGUCUUCAUGAGUUCCCUUUAACGCUUCAUUGUUAAUAUUCAAACUACAUUUAUUUCCAUAAAUGUUUGAUCGAUUUGUAUAUAACACUGAAGUGUUUGGGGGGACUUUUGGUGUCAUUCUGGCGUAGUUACGAUUAU	((((..(((((((.........((((((((.(.(((.((((((((((.(((((((((.(((((((((((((...((((((((....)))))))))))).......)))).))))).))))))))).)))))))))).))).).)))).)))))))))).)..)))) 
aly-mir395d	ACAAAAUAUAAUUCGACUAGAUGUCCUCUAGAGUUCUCCCGAACACUUCAUUGGAAAUUUGUUAUUCGGUAAACUACCAAUUAAUUCCACUGAAGUGUUUGGGGGAACUCCGGAUGUCAUUUGGUGAUGUCAAGCCAUGU	............((.((((((((.(.(((.((((((((((((((((((((.((((.....((((...((((...))))...)))))))).)))))))))))))))))))).))).).))))))))))............. 
aly-mir395e	GUCGGAUGUUUCCUAGAGUUCCUCUGAGCACUUCAUUGGAGAUACCAUCUUUUAUCAAAUGGUUUUCUACUGAAGUGUUUGGGGGAACUCCCGGACUCAUUCGAU	((((((((..(((..((((((((((((((((((((.((((((.(((((..........))))))))))).))))))))))))))))))))..)))..)))))))) 
aly-mir395f	GUCAAAUGUCUCCUUGAGUUCCCUUAAACGCUUUAUUGUUCACACUUUGUUGUCUAAGAUCAAUCGAUCGAUUCAAUCAAUCUGACGAACACUGAAGUGUUUGGGGGGACUCUAGGUGACAUAUGGC	((((.(((((.(((.((((((((((((((((((((.(((((.((..((((((.....((((....))))....))).)))..))..))))).)))))))))))))))))))).))).))))).)))) 
aly-mir395g	GUCGGAUGUUCCCUAGAGUUCCUCUGAGCACUUCAUUGGAGAUACCAUUGUCUAUGAAAUAGUAUUCUACUGAAGUGUUUGGGGGAACUCCUGGACUCAUUCGAU	((((((((...((..((((((((((((((((((((.(((((.(((.(((........))).)))))))).))))))))))))))))))))..))...)))))))) 
aly-mir395h	GUCAACUGUCCCCUUGAGUUCCCUUAAACGCUUCAUUGUUCAUACUUUGUGAGUUUGUGUUCUAAGAUCUAUCGACCGAUAAAUCAAUCUGAUGAACACUGAAGUGUUUGGGGGGACUCUAGGUGACAUCUUGGC	(((((.((((.(((.((((((((((((((((((((.(((((((.(....(((..(((.(((............))))))....)))....)))))))).)))))))))))))))))))).))).))))..))))) 
aly-mir395i	CUCAAGAGUUCCUCCGAACACUUCAUUGAAAAAAGGUUCUCCAUUUUCGUAAUUUUUUUUUACUGAAGUGUUUGGAGGAACUCCAGAUGAUAU	.((..((((((((((((((((((((.(((((((((((((.........).)))))))))))).))))))))))))))))))))..))...... 
aly-mir396a	UCUACGUGACCCUCUCUGUAUUCUUCCACAGCUUUCUUGAACUGCAAAACUUCUUCAGAUUUGUUUUUUUUAUAUAUAUGUCUUACGCAUAAAAUAGUGUUUUUGUUCACAUCUCUGCUCGAUUGAUUUGCGGUUCAAUAAAGCUGUGGGAAGAUACGGACAGAGUCAAAGA	......((((.((.((((((((.((((((((((((.((((((((((((.(.((..((((..(((.......((((.(((((.....))))).....))))........)))..))))...))..).)))))))))))).)))))))))))).)))))))).)).)))).... 
aly-mir396b	GAAGAAGAAGAAGAAGAUCCUGGUCAUAUUUUUCCACAGCUUUCUUGAACUUUCUUUUUCAUUUCCAUUGUUUUUUUUUUUCUAAACCAAAAAAAAAGAUCUCUAAAAUUUAGCAUUUUGGAAACAAAGAAGAAGCUCAAGAAAGCUGUGGGAAAACAUGACAAUUCAGGGUUUUACUCCAUUGAUUC	.........((..((((((((((((((.((((((((((((((((((((.(((.((((((..((((((.(((((((((((((........)))))))))).............)))...))))))..))))))))).)))))))))))))))))))).)))))....)))))))))..))......... 
aly-mir397a	UCCUGGAUUUGAAUGAACAUCAUUGAGUGCAGCGUUGAUGUAAUUUCCUUUUUUUUUCAUUGUUGAAUGGAAUUAAAAGAAUUUACACCGGCGUUGCGCUCAAUUAUGUUUUUCUUAUUUUCAGGA	(((((((..(((..((((((.((((((((((((((((.(((((.(((.((((..(((((((....)))))))..))))))).))))).)))))))))))))))).))))))...)))..))))))) 
aly-mir397b	CCUGGGUUUGAAUAAACAUCAUUGAGUGCAGCGUUGAUGUAAGUUUACUUAUUUUAUUCCAUUGUUGAAUGAAUUAAAAUGAUACAGAAUACAUCAGCGUUGCAUUCAAUUAUGUUUUUCUAAUUUUCAGG	((((((...(((.((((((.(((((((((((((((((((((.......((((((((...((((....))))...)))))))).......))))))))))))))))))))).))))))))).....)))))) 
aly-mir398a	UAAUCAGUGGAAGUAAAGUAUGAAGAAAAAGAGAAGAACAACAGGAGGUGAAAUCUCAAAGGAGUGUCAUGAGAACACAGAUCCUAUGGUUUCUUUACAUUUUCAUUGAAACCAUUGAGUUUGUGUUCUCAGGUCACCCCUUUGAAUCUCCCCUGUUCCUUUAUUUUACCUUACCAAAAUUA	.......(((((((((((((.............(((...((((((.((.((....(((((((.(((.(.(((((((((((((.(.((((((((..............)))))))).).))))))))))))).).))).))))))).)).)))))))).)))))))))).))).)))...... 
aly-mir398b	GAUAUAUUUUGAAGGUAGUGGAUCUCGACAGGGUUGAUAUGAGGACACAUGUGUAAUCAACGGCUGUAAUGACGCCACGUCAUUGUUACAUGUGUUCUCAGGUCACCCCUGCUGAGCUCUUUCUCUACCGACCAUCUUUAUC	((((.........(((((.(((.((((.(((((.((((.((((((((((((((.............((((((((...)))))))).)))))))))))))).)))).))))).)))).)))....))))).........)))) 
aly-mir398c	GGUAGUGGAUCUCGACAGGGUCGACAUGAGAACAUAUGAGCAAUCAACGGCUGUAAAUGACGCUACGUCAUUAUUACAUCUCUCGGUUUCAUGUGUUAACUCAGGUCACCCCUGCUGAGCUCUUUCUCUACC	(((((.(((.((((.(((((..(((.(((((((((((((..((((...((.(((((((((((...))))))..))))).))...)))))))))))))..)))).)))..))))).)))).)))....))))) 
aly-mir399a	CAUGUGAGAUGGAUCAAAGGUGGAAAUGUAUUACAGGGUAAGAUCUCUAUUGGCAGGAAACCAUUACUUAGAUCUUUGCAUCUCUUUAUGCAUUGCUUUUAAGUGAGUUCUCUGCCAAAGGAGAUUUGCCCGGUAAUUCUUCUGCACCAAUAUAUUGAUAUG	(((((..((((.......((((.(...(.(((((.(((((.(((((((.((((((((.(((..(((((((((.(..(((((......)))))..)..)))))))))))).)))))))).)))))))))))).))))).)...).))))....)))).))))) 
aly-mir399b	CAUGUAAGCUCACAAGUUUUAGGGCGCCUCUCCAUUGGCAGGUCCUUUAUUUCCAAAUAUACACAUACAUAUAUGAAUAUAGAAAAUUUCGAUUUAUAUAUGACCUGCCAAAGGAGAGUUGCCCUGAAACUGGUUCAGCUUAAUUAAACACAUG	((((((((((.((.((((((((((((.((((((.((((((((((........................((((((((((...(((...))).)))))))))))))))))))).)))))).)))))))))))).))..)))))........))))) 
aly-mir399c	UAAGCGGAGCAGUAAUAGGGCAUCUUUCUAUUGGCAGGAGACUCGGCUAUUUGUAUCUUUUGUGUUCUUGGCUAUUGGCUAUGUCACUUGCCAAAGGAGAGUUGCCCUGUCACUACUUCCGCUUA	(((((((((.(((.((((((((.((((((.((((((((.(((..(((((...((................))...)))))..))).)))))))).)))))).)))))))).))).).)))))))) 
aly-mir399d	GAGAGAUAAUGUAUGGUUGGAUUACUGGGCGAAUACUCCUAUGGCAGAUAGCUUUGCCUAGAUAUGCAAGCAAAAUGCUUCUCUGCCAAAGGAGAUUUGCCCCGCAAUUCAUCCAUGCAAAACAAUACAUCUUUC	(((((((..(((((((.((((((.(.((((((((.(((((.(((((((.((((((((............)))))..)))..))))))).))))))))))))).).)))))).))))))).........))))))) 
aly-mir399e	AGUGAGAGAGGAAAACAGAGAUUAUGUUUUGGUAGAAAGCAUUACAGGGCGAAUCCUCUAUUGGCAGGGGAAGUUGAUGAGUGUUGAUCACUCUUAUAUUUUCUCAUCAUUUUCCUCUGCCAAAGGAGAUUUGCCUCGCAAUGCUUCCCUACCGUUAUGGCGUUAUUCAUUUCUCCAAUGUCCAAUCUACU	(((.(((..(((.....((((..(((((.((((((.(((((((.(.(((((((((.(((.(((((((((((((.(((((((.....................))))))).))))))))))))).)))))))))))).).)))))))..))))))....)))))........)))).....)))..)))))) 
aly-mir399f	AUGAAAGAUACAUAGAGAAGGUGCAAAUACAUUACAGGGCAAGAUCACCAUUGGCAGAAAUCUAUUACUUCAUUCUUGCAUAAUAUGCAUUAAUGUUUGUGGUGAGCUCUCUGCCAAAGGAGAUUUGCCCUGUAAUUCUCUUGCGCCAAUGUUUUAGAUAUCUUCAU	(((((.((((..(((((..(((((((....(((((((((((.((((.((.((((((((..((.(((((..((((..(((((...)))))..))))...)))))))....)))))))).)).)))))))))))))))....)))))))....)))))..))))))))) 
aly-mir399g	GAUGAUGCAUGGUUGGAUUACAGGGCAAAUACUCCAUUGGCAGAUAGUUUUCGCUACAUCUAUAUUAUUUGUUAUUAUAUGGGUGAAUCAAUGUAUGAAAAAUACUUUACUGCCAAAGGAGAUUUGCCCCGCAAUUUGUUCCAUGCAAAAGAACAUC	.....(((((((.((((((.(.((((((((.((((.(((((((.((((....))))(((((((((.((.....)).))))))))).......((((.....))))....))))))).)))))))))))).).))))))..))))))).......... 
aly-mir399h	AUUACAGGGCAAGAUCUCUAUUGGCAGGAAACCAUUACUUGACCUUUGCAUCUCUUUAUGCAUUGCUUUGUAGUGAGUUCUUGCCAAAGGAGAUUUGCCCGGUAAU	(((((.(((((.(((((((.((((((((((..((((((..((.(..(((((......)))))..).)).))))))..)))))))))).)))))))))))).))))) 
aly-mir399i	GCAUGGUUGGAUUACAGGGCAAAUACUCCAUUGGCAGAUAGUUUUCGUUGCAUCUAUAUUAUUGAUUAUCGAUGUAUGAAAAAUUCUUUACUGCCAAAGGAGAUUUGCCCCGCAAUUCAUCCCGUGC	((((((.((((((.(.((((((((.((((.((((((((.(((((((((.(((((.(((........))).))))))))))))...)).).))))))).)))))))))))).).))))))..)))))) 
aly-mir400	CGACCAAAAGGUAUAUUCUUUAAUUGUUCUUAGGAAGAUGUUGAAGAUUGUUUAUGAGAGUAUUAUAAGUCACUACAUUUGGUAUGCAAAAGUUUUGUUUCCCAAACGAAGUGACUUAUAAUAAUCUCAUGAAUGGAUUUUGCAACUCUUAAAGAGAAAAUUAUAAUUCUUUUGUUG	((((.((((((...(((...(((((.(((((...((((.((((((((((.(((((((((.((((((((((((((.(.(((((...(((((...)))))...))))).).)))))))))))))).)))))))))..)))))).))))))))...)))))))))).))))))))))))) 
aly-mir402	GAGUUGCAUAGUGGCAGUCUUCUUUUGUUUUUAUUUCACCAUGAUCCUUGGCCUAUUGAACCUCUGUUUUAACUGCUUUUGAAAAGUUUUCCUUUUUAGAAAUCUUCUUGUCUCUUUCUCCAACAACAUCCCGUUAGUUCUUGGAAGAAAUUAAGACUGACUUCCAAAAACCCUUUUAAAACAGAGUUCCGUAGACCACGGAUUGCAAAAGAGACUAUGCCACUGAAAACUU	(((((...((((((((((((.(((((((..............(((((.(((.((((.((((.((((((((((....((((((((((.....))))))))))........((((.(((((((((.(((.........))).)))).)))))...))))..................)))))))))))))).)))).))).))))))))))))))))..))))))))..))))) 
aly-mir403a	GAAGAGUCGUAUUACAUGUUUUGUGCGUGACUCUAAUUUAACAGGCUUAUGUUUGAGAUUUUUUUGACAAAUCCGGAUUUUGCUGUUGGAUUAGAUUCACGCACAAACUCGUAAUCUGUCUUUUC	((((((.((.(((((..((((.((((((((.(((((((((((((.(....(((((.(((((.......))))))))))...)))))))))))))).))))))))))))..))))).)).)))))) 
aly-mir403b	GAAGAGUCGUAUUACAUGUUUUGUGCGUGACUCUAAUUUAACAGGCUUAUGUUUGAGAUUUUUUUGACAAAUCCGGAUUUUGCUGUUGGAUUAGAUUCACGCACAAACUCGUAAUCUGUCUUUUC	((((((.((.(((((..((((.((((((((.(((((((((((((.(....(((((.(((((.......))))))))))...)))))))))))))).))))))))))))..))))).)).)))))) 
aly-mir408	AAAGGUUAGAUUGGUAUUGCAAUGAAAGAAGUGGUAAUGAUAGAGAGAGACAGGGAACAAGCAGAGCAUGGAUUGAGUUUACUAAAACAUUAAACGACUCUGUUUUGUCUCUACCCAUGCACUGCCUCUUCCCUGGCUCCCUCUUUUCUCUCUCUCUCUCUCUCUCUCCCUCUCUCUAUUUCUUUCUCUCCUUUCAUUUCAAUGGAUUUUU	.........((((......))))(((((((((((....((.((((((((((((((((...((((.((((((...(((...((.((((((...........)))))))))))...)))))).))))...))))))).......................)))))))))...))...)))))))))))..(((............)))..... 
aly-mir4221	CUAGUAUACCAGUUAACAGUUUUCCUGCUUUUGAAUUCUUGCACUAGCUUCCAUUGAUAGAUAAUGGUUACAUUUUGGUGCUGCAACUCUUGUGGUAGCUAGUACAAGAGUUCAAAAGUAGUGAAGAUGUUAUUUGGAUACCAUAUA	...((((.((((.(((((.((((((((((((((((((((((.(((((((.((((.(((((..((((....))))......)))....))..)))).))))))).))))))))))))))))).)))))))))).))))))))...... 
aly-mir4222	ACCAUCCCUAUGUUGAAAGCGGUAACAAUCUCGAUGAAAGAGAGGAUGUAGACGCUCAACUGAUAUAGGAAGCAAUUGUUUUGAUUAUUGCAUCCUUCACCUUGUUGAGCAUCUAUACCCACUCUUUCAUUCGAAAUUGUUACCGCCCUCAGCCUUUGGAUAUUUC	...((((....(((((..(((((((((((.((((((((((((.((.((((((.(((((((......((((.(((((..........))))).)))).......))))))).)))))).)).)))))))).)))).)))))))))))..)))))....))))..... 
aly-mir4223	GCUUCUUGCUUUGCUUGACUAUGGAAUUUGAUAAAUAAACACAAAAUAUUAAACGCAGCCGUUUUCUGGUGGGCCAAAGUUUCCCUUUUUCGUUUAAUUUUUGUGUUAUUUAUCAAAUUCCAUUGUCAAGCAAAAAAGACAACCU	...((((..((((((((((.((((((((((((((((((.(((((((.((((((((..((((.....))))(((.........))).....))))))))))))))))))))))))))))))))).)))))))))).))))...... 
aly-mir4224	AAAGGUUUUUUUCGGGACAGAGAUGAGAAAGACUCAGCUAUUUGUUGAAAAUGAAAUAUCUGUGAAGCGAAAAACCUUUUUUUUUAUUCAACAAACAACUGAGCUUCCUCAUCUCUGUCACAAUAAGAGAUCUAUG	..(((((((((...(((((((((((((.(((.(((((...(((((((((...((((.....((..........))....))))...)))))))))...)))))))).)))))))))))).)...)))))))))... 
aly-mir4225	ACCAAAUCAUGUUUAUUUUAGAAUCGAUGGUUAAACAACACAUUUUGACGACAAAUUUUGGCGACUAUCAGUUAUAUUUUCGAGUUAUGAUUUUUGUCACUCAAAUGUGUUCUUUAAUUCAUCGAUUCCUAAAUAAACAAGAUUUGACCA	..((((((.(((((((((..(((((((((((((((.(((((((((((((((.(((((.((((.....................)))).)))))))))))...))))))))).))))).))))))))))..))))))))).)))))).... 
aly-mir4226	AAGCAAUGAAUAGUACAUUGUACAAGAUGCAUUCGAGCAAUAAAUGAGUUUGCAUGCCCUCGUGGCUUUGUUCUUCCAACCAUUUUUGUUUGUCAUCAUCUGAUACCCUCACCCAAACUCAUUUAUUGCUCGCAUUCGUUUGUACAAUGUACAAACUCAAUUGAGA	............((((((((((((.((((.((.(((((((((((((((((((...(((.....)))........................(((((.....)))))........))))))))))))))))))).)).))))))))))))))))...(((....))). 
aly-mir4227	GUUCACACGACAACACAAUUUCAUUUGUGCCAAUCAUUCUAACAAAGUAUACCUCGGUCUCAGUGAUGGCAUACUUUGCUGGAUUGAUUGGUACACAUGAAAUUGUGAUGUUAUCGGCAGUA	........((((.(((((((((((.(((((((((((.((((.((((((((.(((((.......))).)).)))))))).)))).))))))))))).))))))))))).)))).......... 
aly-mir4228	CGGCGUGUUGUUUUAACCUAAAAGCCUUGAACGCUGUCGUUUCGCCGUCGACAACAAUCACACGCGCACACUUCCACCAUUAUCAUCUAUCCACCACACAGGUUCGUCGGAUGCGAAACGGUGGUGUUCAGGGCUUUUUUAAGGUUGCUGGAUUUUAUU	(((((..........((((((((((((((((((((((((((((((..((((((((..............................................))).)))))..))))))))))))))))))))))))))...)))))))))......... 
aly-mir4229	ACAUAAAUCGUCCUAAAACCUUGGCAGGGAGGUCCUCCACACACAAUAUUUACAAGGACGUUUUGCACGUUGCAUUCUUUGAAAUUGAUGUGAAUAUUGUGUGUGGAGACAUCUUUGUCAAGGUGUUAGAUGAUUUAUAUUAA	..((((((((((.(((.(((((((((((((.(((.(((((((((((((((((((..(((((.....))))).................)))))))))))))))))))))).))))))))))))).)))))))))))))..... 
aly-mir4230	AAUUAUUAUUAUACCUCUCAUGUCUCGGAAAUUUGCACCCUGUGAUUAAUAUAUUGGAAUCAUUUUUAUUGCUCACAGGGUGCAAACUUUAGAGACUUGAAAUGUGUAAUAAUAAAAUA	..((((((((((((...(((.(((((.(((.((((((((((((((.(((((...((....))....))))).)))))))))))))).))).))))).)))...)))))))))))).... 
aly-mir4231	AAUCAGGUCAUAAAGGCAGUUAGACCUUUGUGUUGCCAUCGUUCUUGGCGCUCGCUUCACCAAAAGCGCCAAGACCGAUGGCAACAAGGAGGUUUAACCGCCUUCUGAGCUGAUUUUU	((((((.(((..(((((.(((((((((((.(((((((((((.((((((((((............)))))))))).))))))))))).))))))))))).))))).))).))))))... 
aly-mir4232	UUUCAUUUUACAAAAAUAGCUAUGUAUACCUGGGGGUCUGAAUCACUUCAUUCAAUACCAAGAAAAAGGACCGGUUAACAUAUCGUUAUCCAAACCGGUUGAUUCACAUUUAUUAGGAUGUGUGCUCGCAUUGAAAAUGAGUGAG	.((((((((.(((....(((.((((((.(((((.(((.((((((((((..(((........)))..)))(((((((...(((....)))...)))))))))))))).)))..))))))))))))))....))))))))))).... 
aly-mir4233	GACAAAUGUAAGAUAUUUGGAGUUGAUGUGGGUGAUUGGUAUGUGGUGCUGAACAAUUGGAUCCAUGGCUAUAUGGAUUAUUUACCGUAAUAAAGUGUAAUCUGUAAUGUUUAACAUCACAUACACAUCAUCAACAUCAACUCCAAAUCUUUUGUUUGUCCUUU	((((((((.(((((..(((((((((((((.((((((..((((((((((.((((((....((((((((....))))))))..(((((........).)))).......)))))).))))))))))..)))))).)))))))))))))))))).)))))))).... 
aly-mir4234	UUAUGAGGUUUUCUACUCAUUGUCAACUGGGUUUAAGUUGGAAAUUCAUGAUUUCUCAUAUCAAAGCUAGGUUGGUCCAAUAUUAGAAAUUAUGGACUUCCAACUUAAAAUCAGUUGGCAAUUUUUUUGGACUAUUUCUCAU	..((((((...((((...((((((((((((.((((((((((((.((((((((((((.((((....((((...))))...)))).)))))))))))).)))))))))))).)))))))))))).....)))).....)))))) 
aly-mir4235	CUGUAGUAUGUGUGAUUUCUGGGUUGUAUUGUUUUCAGUUCCUGUUCUGUAAGUGAAUAUGACCAAUACUUGUUGGUUACACUCAAGCUGUACAGAACAGGAACUGAAAACACUACAACCCCUAGAUCUUGGUACUUUUUACU	....(((((....(((((..((((((((.(((((((((((((((((((((((((((...((((((((....))))))))...))..))).)))))))))))))))))))))).))))))))..)))))...)))))....... 
aly-mir4236	AUAAAAUCGCAAAUCUGUUAGGAGGGAAACAAAUUAAUGUCUUAUAGGACGCAAGGGCACCAAUACUCUUAAGCUAUUGUGGUGACUGCUAUCCAAGGUCUUAUAAGGCAUUAAUUUGUUCCCCUCCUAAUGCAUGUGGAAUUCUAAUC	.......((((....(((((((((((.((((((((((((((((((((((((((.(..((((((((((....)).)))..))))).))))........))))))))))))))))))))))).)))))))))))..))))........... 
aly-mir4237	AAAGACUGUUCUAUGACAUCGAUUAUAUGUUUACGUUUGUUUUUACGUUAACAUGUAAUAAUAGUUUGCUAUAAACGUAAAAACAAACGUAAACAUAUAUAAUCGAUGUCAUAAAACUAUAUUUAC	.......(((.((((((((((((((((((((((((((((((((((((((.....((((.......))))....))))))))))))))))))))))))))..)))))))))))).)))......... 
aly-mir4238	UUUCAAGAGUGAUUUGGUUUGGGGUUUUAAUUUGCAAAAAUUUGAAGUCAAUGUGUGCUAUUCGCAUAAAGACUUCAAUUUUUUUGCAAAUUAAAACCCCAAACCAGUAAUUCCUAAUCAUG	......((((...(((((((((((((((((((((((((((.((((((((..((((((.....))))))..))))))))..)))))))))))))))))))))))))))..))))......... 
aly-mir4239	UCUUGUUUGCACACUUUGUUUCCGUUAUUUCCGCAUGCUCCUUAGAAAUUUUUGUGCAUCGAUAUAAAAUCCUUUCAUAGGAGCAUACGCAAACAAUGGAAACAAGGAAUGCAAAUAAAACU	..(((((((((..(((((((((((((.(((.((.((((((((..((((.(((((((......)))))))...))))..)))))))).)).))).)))))))))))))..))))))))).... 
aly-mir4240	UUUUCGUAGCCGUGAAGUUAAUGGCUAGAGUGACUAGACCCGUAACAUUGCUAUGAAAUCAUUUGAACUGAAAUUUGUUGAUCUGCGGUUUAUUUUCAAGAGAUCAAAACGAAGAUAAGUGGUGGCACAAGUUUACUUUAGCGAAUUUAUCGCUAUGUUAUCGGGUCUAGCACUCUAUCCACUGAUUUCACGACCACGAGCCUC	..(((((.(.((((((((((.(((.(((((((.(((((((((((((((.((.(((((.((..(((((...((((((((.(..((((.((((((((((.............)))))))))).)))))))))))))..))))).)).))))).)).)))))).)))))))))))))))).))).)))))))))).).))))).... 
aly-mir4241	GAACGAACUAAACCUCAUUCGAUGUAAGAAAUCCCAAAAAGGACAGGGUUCAUAAACAUUCGCUCUAUGGCCCAUGAUAAUGUUGAGUCUGCUACGUGACUUACAUUUUUGUCGGGCAGAUCACGCCAAUACACACCUGGUCUCUUUGGGAUUUUCUUACAGCGAAUGAGGUUUAGUUCCAUCUC	((..(((((((((((((((((.((((((((((((((((..((((.((((..............(((...((((((((.(((((.(((((........)))))))))).)))).)))))))..............)))).)))).))))))).))))))))).)))))))))))))))))..)).. 
aly-mir4242	CCCAAAUCCUCAGAACUUGGGAAUGCUAUUGUUAACUUUUCUCAAGCAGUGUCUGAUGGGCUGCUGAUAUUUUUCUCUUCCUAUUACCCUGUGGAAUGUUGCAUUGCAUUUGGAAAGAUGUGUGUUACAGAAACUCUAGAAAAGUUAACUAUGGCAUUCCCUAGUUCUUGGAAUUGGAAGC	.((((.(((..((((((.(((((((((((.((((((((((((..((((((.(.....).))))))((......))..((((...........))))(((.((((.((((((....)))))))))).)))........)))))))))))).))))))))))).)))))).))).)))).... 
aly-mir4243	UUAAGAACCAUGAUUACAGUUGAAAUUAUAGAUUUCGUACAUGACAACAAUUUGCUCUAGUCUCACUCUCAAGAUUUUGUGGUUGUUGUUGCAGUAUUCGAGAGAAUACAUGUCAAAUAUGAGAGCAUGCAUGUCAUGUACGAAAUCUACAAUUUAAACUCUAAUUAAUGGAUGGUUCU	...(((((((((((((.((((.(((((.((((((((((((((((((......((((((....((((............)))).((((...(((((((((....)))))).)))..))))..))))))....)))))))))))))))))).))))).)))).))))).....)))))))) 
aly-mir4244	AUUAUCCAAAGUUGUCGUCGUUGUUGAUUCCUUGGAGAUUGAAUUUGAGAUAUUCAACGAAAUUCGAUCUCCAAAGAAUCCACAACAAUGAAAACUUUGUUGAUCAU	......(((((((.((((.(((((.(((((.(((((((((((((((.............))))))))))))))).))))).))))).)))).)))))))........ 
aly-mir4245	AGCCCAAUUUGAAGAUGAAUUGUCAGUAUAAAUCUUUGAUCCAAUAUACUUUUGAUUAGUAGAUGAGUUUUUUUUGACAAUUAUCAAUUAUAUUAAAGAGUGAUCAAUUAGUAUUGGAACAAAGUUUUAUACUGACAAUUCGAUCUUAAAAAGCAGAAG	...........(((((((((((((((((((((.(((((.((((((((....(((((((.(...(((.......((((......)))).....)))...).)))))))...)))))))).))))).)))))))))))))))).)))))............ 
aly-mir4246	UCACUCAUACAGCAGAAACCAAAUCCAAUUUUCAUUGCUUAAACCUGUGUUUAAUUUUGUUGCAAGAUUUAAGCAAUGAAAUGGGAUUUGGUUUCCGCGGUUGGAGCGGUA	((.(((..((.((.((((((((((((...((((((((((((((.((.(((...........))))).))))))))))))))..)))))))))))).)).))..))).)).. 
aly-mir4247	AAAUUAUAAUUCCUUGAAUAUGUAUCCUAAUAUUAGACCCCCAUUUAGUUUUAUUUAUGAACAUGGAAUUUGCAAGGAAACAAUAUAAUACUUAAUGGGGGUCUAUUAUUAGGAUACAUUUUCAUGGAACAAUAAUUUUG	(((((((..((((.((((.(((((((((((((.((((((((((((.(((.((((.......(.((.......)).)........)))).))).)))))))))))).))))))))))))).)))).))))..))))))).. 
aly-mir4248a	UGUGGUGAUAUUCAAAAUAUACAUUUUAUUUUUGGCAAUCAUUUUUCUUUUAUAAAUUCAAAAGUCAUUUUUCUUUCUAAAAACACAAUAAUAUAUAUAUAUAACCAACGUUUGAGUUUUAAAAAAGAAAAAUGAAUUUAUAAGAAAAUGAUUGCCAAAAAGAAAAUGUAUAUUUUGUUAUAUUACAAAAA	....(((((((.(((((((((((((((.((((((((((((((((((...((((((((.......((((((((((((...(((((.(((.......................))).)))))...)))))))))))))))))))))))))))))))))))))).)))))))))))))))..)))))))..... 
aly-mir4248b	UGUGGUGAUAUUCAAAAUAUACAUUUUAUUUUUGGCAAUCAUUUUUCUUUUAUAAAUUCAAAAGUCAUUUUUCUUUCUAAAAACACAAUAAUAUAUAUAUAUAUAUAUAACCAACGUUUGAGUUUUAAAAAAGAAAAAUGAAUUUAUAAGAAAAUGAUUGCCAAAAAGAAAAUGUAUAUUUUGUUAUAUUACCAUAA	(((((((((((.(((((((((((((((.((((((((((((((((((...((((((((.......((((((((((((...(((((.(((...(((((((....)))))))........))).)))))...)))))))))))))))))))))))))))))))))))))).)))))))))))))))..))))))))))). 
aly-mir4248c	UGUGGUGAUAUUAAAAAUAUACAUUUUAUUUUUGGCAAUCAUUUUUCUUUUAUAAAUUCAAAAAAGAAAAUGUAUAUUUUGUUAUAUAUAACCAACGUUUGAGUUUUAAAAAAGAUAAAUGAAUUUAUAAGAAAAUGAUUGCCAAAAAGAAAAUGUAUAUUUUGUUAUAUUACCAAAA	..(((((((((..((((((((((((((.((((((((((((((((((...(((((((((((.........(((((((......)))))))....(((......)))..............))))))))))))))))))))))))))))).))))))))))))))...)))))))))... 
aly-mir4249	UACACAUUUCUUGUUCAGGUUGAAUUUGAGAAGUUGAGGUAGGUUUACCAACUCUUGAAUUUCUCACACUCUCGAUCAAGUUUCUCUUAUCGAGUUUGGUUUCUCAAACCCACCUCAAAUUCUCCAAUUCCACCAGAACCUUAAAAAUCUUUA	............((((.(((.(((((.(((((.(((((((.((((((((((....(((.....)))....((((((.(((.....))))))))).))))).....))))).))))))).))))).))))).))).)))).............. 
aly-mir4250	CGUUGCUUCAUGAUCAGUCCUCCAAAGGCACAAGAACAUCAAAUAGGUGACACCAAGAUGUGUUUGUUUGGUUUCACCUAUUUGAUGUUCUUGCCCUUUAGGAGGAUUGAUCUUGCCACAACCCU	.((((...((.(((((((((((((((((..((((((((((((((((((((.((((((.........)))))).)))))))))))))))))))).))))).)))))))))))).))...))))... 
aly-mir472	CCAAGGGGGAGUCAUAUUCUCAUCAAAGAUGGAUUCGGGGUUACGCCUCUGUAUGUAUGGUCGAAGUAGGCAAAAUCUCACCUUUCUAGCAGAUCAACAAUAGAUGCUUGAUUUAUAAAGGUUGUGGUGUUUGAAAGUGUUGAGAUCCGCAAGAUUUGAGUAAGAUUUUUCCUACUCCGCCCAUACCAUGCAUACACCUAAUCCUGAGUCCAUCUCUGAUGGGUUACUAUUGG	((((.((...........(((((((.(((((((((((((((((.(....((((((((((((((.((((((.(((((((.(((..(((.((.((((((((.((((((((.(((((....)))))..))))))))....))))))..)).)).)))...).)).))))))).)))))).)).....))))))))))))).))))))))))))))))).)))))))...)).)))) 
aly-mir771	AUUCCACAUGAGCCUCUGUGGCAGCCCUCGCAAUGAUCUCAGUAGAGUGCAUGCCAAGUUCUUGUAAAGACGUAGAUGAGGGCUCCUCAGAUGUUCAUGUCGAAU	((((.((((((((.((((.((.((((((((((.((..(((....)))..))))).....((((((....))).))).))))))))).)))).)))))))).)))) 
aly-mir773b	GCAUCAACAUCCUCGAACGAACGAGGGAGUGUAGAUGCUUAACGGGUGAAGGAGGCAAUAUCUUUGAACAAACAGUUGAUUUUAGAAUUCCAACAACUAAAGGUGUGGAGAACAUACAGUACCUUUAGUCGAUGUACUUCUGCAAUCAAUUGUUCAUUCAAGGAUAUUGUAUCCUUCAACUUUUGAGCGUCAAAACCCUCUCAUUCAGUUCGAGAAUUAUUGUCGC	((..(((....((((((((((.(((((.((...(((((((((.((.(((((((.((((((((((((((..(((((((((((.(((((...((.(.((((((((((((.........)).)))))))))).).))...))))).)))))))))))..)))))))))))))).))))))).)).)))))))))...)).))))).))).))))))).....)))..)) 
aly-mir774a	GCGUUGUUCAUUUGGAUUCAUAUUCGAGACGAAGAUAUGGGUGACUAAUACUUAAGAUUUUGGUCAAUUUAAAUUACCAAUCUAAUUAUUUGUUACCCAUAUCUCCAUCUCCAAUUUAAUCUCUUAAAAGUCGU	(((..........(((((...(((.((((.(.(((((((((((((.((((.(((.(((..((((.(((....))))))))))))).)))).))))))))))))).).)))).)))..))))).........))) 
aly-mir774b	GGAUUCACUUGAGAUGAAGAUUUGGAUGACAAAUACUUAAAACUUUGGUAAAUUUAAAUUACCAAUUUAAUUAUCUGUCACCCAAAUCUUCCUCUCAGGUUUAAUCU	(((((.((((((((.((((((((((.(((((.(((.(((((...(((((((.......)))))))))))).))).))))).)))))))))).))))))))..))))) 
aly-mir781	GUUUCAAUUUAGAGUUUUCUGGAUACUUAAUAGUUACUAACAAAGAAAGGGUUUCUUCUAUAUUAACUUCUAAGUAUCCAGAAAACUCUAAUUUGAAAC	(((((((.(((((((((((((((((((((..(((((.((...((((((...))))))...)).)))))..))))))))))))))))))))).))))))) 
aly-mir822	GAAGUGACAAUAUCCUUUAUGUGAUAGUACUCGUGAUUGGAAUCGCAAUAACAAGGUUUGCAGUGGAAGUAAUCUUUUUCAAUCAUCAUAUCCAUUUACAACGACUUUAAGUAUAAGUCGAUAUAUGGGGAUGUAACGCAUGUUGUUUUCUGCGAGGAGCAUUUGUACAUGUUUCAUGUAGCAUGAAAUCACAUUCCAUACAUGAAUAGUAAUUACCUUAGAUAGGACAUUGUACUGCUUGAAAAAACUUGUUAACGUCAUAAAAUUUAUGAUGAAAACACCUAUAAAAAGUGUUUUUUCAAGCAUGUGUCCAUGAGAGUAAUUUUUAUUCAUAUAUGACAUGUGAUUUCAUCCUUCAUAAAAUGUGUGCAAAUGCUUUCCACAGGAAACAACAUACGUUACAUCCCAUCUACUUACACUUAAAGUCGUUGUCUAUGAAUCUGAUAAAAUGUUACUUCGACUGUAAGCAGUGGUUUCGUCUAUGAGUGUCGCAUACAUGUACGAUCGGAGCUUU	(((((..(...(((...((((((...(((((((((((.((((((((.........(((((((((.((((((((.((((......((((.((.(((..(((((((((((((((.(((((.(((.....(((((((((((.(((((((((((((.(.(((((((((((((((((((.(((.((.((((((((((((..((((.((((((((.((((((((((....((((((.....(((((((((((((.((((..((((((((...))))))))..))))............))))))))))))).)))))).)))).)))))).)))))))).))))..)))))))))))).)).))).))))))))))))))))))).).))))))))))))).)))))))))))))).))))).)))))))))))))))..))).)).)))))))).)))))))).))))))))).))))))))))).))))))).)...))))))...))).)..))))) 
aly-mir823	GGAGAAAGCUUUUUUUAAGUGAAAAAUUUCAGGGAUGCUAAUCCAAUAGAUGGCGGAUACGUUUUCCAAUCACGAAUCUUGUAUGAUCACUAACCAUUGGAAGUAAAAGAGUAUAUAUGACUUCGAACGGUUUGCAAUACGGAGGCUCAUAGCAACCCUUUCUUCUUGCUAAUAUUGCAACUUGCAAGCCGUUCAAAUUAAAAUAGUCAUCAUUUAGUUCUAGGUUGGUGAUCAUAUAGGAUUGGUAACAGUGAAACAUAUCCCCCAUCUAUCGGGAUUAAUUAGUGUCCCUGAAUAGUCGUGAGAGAACCUUGUUUGUGUCUUU	.....(((.((((((((..(((.....(((((((((((((((((.((((((((.(((((.(((((......((.(((((((((((((((((((((..(((((.((((.((.......(((((..(((((((((((((...((..(((...)))..))........((((.......)))).)))))))))))))..........))))))).)))).)))))))))))))))))))))))))).))......))))).))))).))))))))..))))....)))))))))))))...))))))))))).)))............ 
aly-mir824	AGUUGUCUCUCAUGUCUAGACCAUUUGUGAGAAGGGAGUUUUUGUUUGCACCAAUACCCACCAAUCUCUAAGUUUGUAAGAAGUAUUAUGCUCAAUUAAGGAAAAUAGCUAGUUCAACUUACCACACUACCCUUUUACAAACUAUCCUAUAUGUUAGAUGCUAGCAUGGCGUAAUUUUGUGUUCUCAUUCUGCAGCAGGGUUAGUUUCUUGUGUACCUCUAGAUAUUUAUUCUCUUGCUGCGUAGGGUUCCCAAGCUGCCAAAAACUUUUCAAAAUUAGAGAUCUGUUCCCCACUAACCCCCAUCCAAUAAGGAAGGUCUACCUGUAUGUAGCUCACAGCUAUUAAAGCUGUGCUCGCGUCUUGGUUUUACUGUUUUAGUUACCCCAUGAAAUCUGAUCCUUCAGAAGUUAGGUAUAGAAGUAAGUCGAUUAAGUUCAUUCAUGACUUUUCCAGAUGUUGCACAGAUAACUUUUUUAUUUGUAUUAUAACUAGUCCAAGCCGAUUCUCGAAAUCAUAUAAAAUCAUUUACACCUUGGUCAUGGUAGCCAAGAAUUUGUAUCUUACACUAGGUUUCCUAAUAAAUAAAAAUGGGGAGUGGGGAGGUGUUUGGUUAUAUUCCCUUCUCAUCGAUGGUCUAGAUGUGCGAGGUGACU	(((((((((.(((((((((((((((.(((((((((((((........(((((.......((..((((((((.((((..((((((..(((..((.......))..)))(((((((((((..................................))).)).)))))).(((((....((((.(..(((....((((((((((..(((.(((.(.......).))).))).....))))))))))..)))..).)))).)))))...)))))))))).))))))))..))((((((((...((((((((.....))..((.((((......))))))(((((((.....))))))).(((.(..(((((((.((((((.((((((((...(((..(((((....)))))..))))))).....(((((((....(((((.......))))).....))).))))((((((((.....)))))))))))).))).)))..)))))))..).)))......................((((((.......))))))....((((...)))).((((...))))..........)))))))))))))))))))........))))))))))))).))))))))))))))).))))))))) 
aly-mir825	GGUAUAAUUCACUGAUUGAUUCCAUCAACUCGUUCAAGCACCAGCUCGAAGAAGCGUAGCUAAUUUAUCUUAGAAAAUCAUGGAUUUGAAAAAGCUACGCUUCUCGAGAAGGUGCAUGAACAAGUUGAUGCAUAUUUUGAUCUGCAAAGACC	(((..........((((((...((((((((.(((((.(((((..(((((.(((((((((((..(((((((...........))))..)))..))))))))))))))))..))))).))))).))))))))......)))))).......))) 
aly-mir827	UACAUCUUUAACUUCCAUGAAACAUUAUAGGGUUUUUUCUCUCUUGCAACCCUUGAAUGUGUUUGUUGAUUGACAUCUAUACAUAUCGAUAAUCCUAUCGUGUUGAUAGAUCGAUUGGUUUAGAUGACCAUCAACAAACGCUUUCGUGGUUUUGCAUCGCUUCUUGAAAUCUUGAUCAUGUUUUUAGCAUCUUUGUA	..................(((((((..(((((((((........(((((.((.((((.((((((((((((.(.((((((.((..((((((....(((((.....)))))))))))..)).)))))).).)))))))))))).)))).))..))))).........)))))))))...)))))))..(((....))). 
aly-mir828	CAUGGACAAAGUCACAAAAGUGAUAAAAUCUCCUUCCACUUUCUAAUGUUUCUUGCUUAAAUGAGUAUUCCAUGUAAAAAAUGAGUCACUCACUCAUAUGGGUGGGUUGGGUUGGUUUUCUCUUCAUGAGAUGCUCAUUUGAGCAAGCAAUGUCUGUGAGUGGAACUAUUUAGUAUCAUGUUAUGAAUUUUGUCUUUUG	...(((((((((((.....((((((........((((((((.(..(((((.((((((((((((((((((.((((...(((((.((((((((((((....))))))))..)))).))))).....)))).)))))))))))))))))).)))))..).))))))))........))))))....)).))))))))).... 
aly-mir829	UGAUUAACAAAAACAAUGAAUCAUUCUACCAAUUGACUUGUACUUUGAAUCUUUGAUUUGAACCUUUCAAAUGGUAUCAAAGCUUCUACAUCUUUGAAGCUCUGAUACCAUGUGAAGGAGUCAAAUCAAAUCUUCAAGGUACUAGUCAACUUGGCAGAGAAAAAAAUGUAGUUGGGAUUA	(((((..(((..(((........((((.((((((((((.((((((((((..((((((((((..((((((.(((((((((.((((((.........)))))).))))))))).))))))..))))))))))..)))))))))).)))))).)))).)))).......)))..))).))))) 
aly-mir831	AAGUGCUACAAGAAUGUAUAGUCUUAGAGUCUCAAGAAGAGGUACAAGGAGAUGAGAAGUGAAUCACUGAAACAAGUGGUUCUGGUUUGUGGAUCAGUAUGGUUUACCCAAAACACGUGUUUGGUGCUUCACUUCUAAACUCCUCGUACUCUUCUUGGGAUUCUAUGACUUACACUUGUUGAUUU	.....(.(((((..((((.((((.(((((((((((((((((.(((.(((((...(((((((((.((((.(((((.(((....(((...((((((((...)))))))))))...))).))))))))).)))))))))...))))).)))))))))))))))))))).))))))))))))).).... 
aly-mir833	UCUAGAGGGUGGUGCAACAUCUCUGGAUGUAAAUGGUACUCUUACAAAUGGUGAUGGUGAAAAGAAAAGGAGCAGCUUGUUAGUCUGAACUCGGUCUAGUUCAAACCAAAACAUCUUUUCAUCCUUGAAAUUCUCUGCAAUUACAAGGUUGAACUUUUUUUCAACCAAGGGCUCACACCGCACUAGGACUCAUACUAUUACCUUACUCUUGUGACAAAAAUUGCAUUAAAGAGAUACGUUUCGGGUUGGAGGAAGUUUGGGGUACGGGUCCUAAUGUCAUGUGAAGAAAAGUUCAGCCCAAUAAUUGCAGAGAAACAUAUGUUUGGUUUGAACUAGACCGAUGUCAACAAACAAGCUGCUUCGUUUCUAUUCACCAUCAACAUCUUUAAUUGCACCAUCGACGUCCAGAAAUGCUGCACCACCCCUCUAGA	((((((((((((((((.(((.(((((((((..(((((.(..(((...(((.((((((((((.(((((.(((((((((((((.((.(((..((((((((((((((((((((.(((..(((((....)))))(((((((((((((...(((((((((((((((((..(((((((((..(((.((......(((..(((...((....((((((((.(((...))))))..)))))....))....)))..)))......)).)))..)))))))..)).....)))))))))))))))))...)))))))))))))....)))))))))))))))))))))))..))))).))))))))))))).))))).)))))))))).)))...)))..).)))))..))))))))).))).))))))).))))))))) 
aly-mir834	UUACAGCGACAGCCAAAAUCACCACAGCUUCUGCUACGAACGUGUUAAGCCAUCCUUUUGACCAUUGCUGCACCACUAUUACGGCCAUCACAAGAAAAUCUAUGCAAGUGGAAACAGUGAUAGUAGCGGCUGGCUAAUGACACGUUGGUAGCAGUAGCGGUGGUAAUGUCGAUAGCGUGA	......(((((.........(((((.(((.(((((((.((((((((((((((..............(((((...((((((((..((((..(((((...))).))...)))).....)))))))).))))))))))..))))))))).))))))).))).)))))..)))))......... 
aly-mir835	GAUGCAAUGCUAGAUGGUCAUCUUUGUGGUUAAGCUCUUUCUUGCAUAUGUUCUUUAUCUCUAUUGAUUGAUAUUUUUCAGCGAGCAACAUUAUAUAUAUAUAUAUAUAUUUUACCUGGAUUUGUAAGAUAAUUUUUAGAUUUCUCGACGUUAUACGCAACAUUAUAAUUUCUGUUGUAGUCAACUUCUGCUGCAACCCAUCCACAAAGCUUAUCAUGCGAGAUUAAACACUUUCUCGAUGGGUUGCAAUAGAACAUCACUAAAAUAGAAGUGAUAUUGUUUGGAAAAACGUCAAAGAACCGAUAUCUUAUAAACAUCUUACAAAUCCAGGUAGAAGAGAAUAUGAGGUUGCUUGUUGAAAAUAACAAUCUAUAAAUUUGAAGAAGAUACGCAAGAAAGAGUUCUAAACACAAAGCUGAUCAAACAUUCUAUUUGAAGAGUU	..............((((((.(((((((..(((((((((((((((.(((.(((((((....(((.(((((.((((((.(((((((((((.((((((.............(((((((((((((((((((((.......((((((((.((((((...(..((((.(((.(((((((((.((((....(((((.(((((((((((......((.......))((((..........))))))))))))))).)))))....)))).))))))))).))).))))..)...))))))..)))).....)))).......)))))))))))))))))))))....)))))).))))))))))))))))).))))).)))....))))))).))).))))))))))))).))..))))))).))))))...(((((......))))). 
aly-mir837	UAUAAAGUCUCCAUGUUUUUUCAUUGUUUCUUGUUUUUUUCAAGAUUAUGAUUUUUGUUUAAUUACAAUCAUAAUCUUGAAACGAACAAGAAACUGAUGAAAAACAUGAGGACUUUAUA	((((((((((.(((((((((.(((((((((((((((.(((((((((((((((...(((......)))))))))))))))))).))))))))))).))))))))))))).)))))))))) 
aly-mir838	GAGGACUUCCAUGGCCUCAAUCCACCUCCGGUGUUGUGCAAGAAUGAGAAGCAAAGCCUGUCUAUGUAUUGUGAGAUAUCUACUUCUAUGACUAGGAUAUAUGUACAAGACCGGCUUUUCUUCUUCUUCUUGCACAACCUGAGGUAAUUGGGGCUAUACAAGUCUUC	((((((((..(((((((((((..(((((.((.((((((((((((.((((((.((((((.((((.(((((......((((((.............))))))..))))))))).)))))).)))))).))))))))))))))))))).)))))))))))..)))))))) 
aly-mir839	CAACUUUCGUUACAACUAUCAUUCGAGUGAGCACAAAGAGUAGCAUAAGCUCUCCUUUGACAUCUUCACCAACCUCUCAUCGUUCCCUUCUCUGUAAUAACGUCGUUUUGCAAAACUGCAAUGGUCCUGAGCCGAUAAGCCUCUAAUGAAAUUAUAGACUCAUCGGCUCAGGACCAUUGCGGUUGUGCAAAACGGUGUUAUUGCCGAGAAGGGAACGCAUGAGAGGUUGGUGAAAACGUCAAAGGGCUCUUAUGCUACUCUUUUUUUUUCUCAUAUGAGUGAGUGAUAACCAUAGUUG	(((((...((((..((..(((((((.(((((...(((((((((((((((..(.((((((((...((((((((((((((((((((((((((((.(((((((((((((((((((.(((((((((((((((((((((((.((.((.((((...)))).)).)).))))))))))))))))))))))).))))))))))))))))))).)))))))))))).))))))))))))))))...)))))))))..)))))))))))))))......))))).)))))))))..))))...))))) 
aly-mir840	GAUUCGGGGCUCGUAAAGCAGGUGAUUCACCAAUUCAGGUUUACAUCCGCAGUGUGGAAGACACUAAAGGACCUAAACUAACAAAGAGAAACAGCUCAUUGUGCGGGGUAUUACACUCUUAAUGUCUGAAUGCGAUAAUCCGCACGAUGAUCUCUUUAUCUUUGUUUGUUUAGGUCCCUUAGUUUCUUCUAUACCGCGAAUGAAAUCCUAUGUUGGACGAAUCAACUUGGUUUACGAUUUCCAAAUC	((((.((((.(((((((.((((((((((.(((((..(((.((.(((.(((.((((((((((.(((((.((((((((((.((((((((.(((.((.((((((((((((.((((.((.((.........)).)).)))).)))))))))))).)).))).)))))))).)))))))))).))))).)))))))))).))).))).)).)))..)))))..))))).))))).))))))).)))).)))) 
aly-mir841	GCACCAACUCUACCAUGUGCAGAAACUAUGGUCUUGAGUUGCCUGUGAAUACGACCCACUGGAAACUAAAAUAAACAAAGAAACAGUAUCAGUGUGAAAUUUCAUAAAAUUAGAGUACAAAGAGACAUGAAAUUUCUUUGUUUACUUCAGUUUUUGAUGGGUCGUAUUCACAUGCAACUCAGGACCAGAGUAUCUACACAUGGUCGACUUGGUG	.((((((.((.((((((((.(((.(((.((((((((((((((.(((((((((((((((.((((((((.((.((((((((((((((((.((..((((....(((.........)))))))..)).)).))...)))))))))))).)).)))))))).))))))))))))))).)))))))))))))).))).))).)))))))).)).)))))) 
aly-mir842	AUAAACUAUUGCAAAAAGAGAGACCACAAGCGGGAUGAUGGAUCCGACCAUGAUGGUGUUGCAGAAACUUAUGUACGAGGUAGUUAUCCAGGGGUCGAAACACCAUCAUGGUCAGAUCCGUCAUCCCACUUAUGUUUUUUUAGGUCAACAAGGAUAU	................((((((((...(((.(((((((((((((.(((((((((((((((...((..(((....((......)).....)))..))..))))))))))))))).))))))))))))).)))..))))))))..(((......))).. 
aly-mir844	GAGUAUAAAGUUGUAAGUUGGUUUGAUGAAUCUUUUAGAUUGAAGAAAAGAAGGACUAGUAAGAUGGCUUAUAAGCUGGAUUUUGAGAGUGAGUGAGCUCUUCUACGCAUUGGCUUAUAAGCCAUCUUACUAGUCUUUCUUUUCUUCAAUGUGGGGAUCAUAACAGUUUUAAGGAAUGUCUC	(((.(((...((..((((((.....((((.(((((.(.(((((((((((((((((((((((((((((((((((((((((.....((((((......)))))).......))))))))))))))))))))))))))))))))))))))))).))))))))))..))))))..))...)))))) 
aly-mir845a	UCAAUAGUUCCAUCGCUCGGUUUCCAUCACGUCGAUUGGUGUCAGAGCCACGCCUAUGAAAAAUUUGCGCGGCUCUGAUACCAGUUGAUGCAAUGGAAACAUCGAUAUUGCCUGA	......((...((((....((((((((..((((((((((((((((((((.(((..((.....))..))).))))))))))))))))))))..))))))))..))))...)).... 
aly-mir845b	AGUUCCAUCACUAGGUUUCCAUCACAUCAAUUGGUAUCAGAGCAACGCAUGAUGUAUAAUAACUAAGCGUCGCUCUGAUACCAAAUGAUGCAAUGUAAACAUGGAUAUUGCU	...(((((......((((.(((..(((((.(((((((((((((.((((..................)))).))))))))))))).)))))..))).)))))))))....... 
aly-mir846	UUUAUUUGAAUUUUAUGUGGAUAUUGGCAGUUUGAGAUUAACCAUCUCAAUAACAAACAUCUUGAAUGUGUUGAGGUUGAUCACGAUGAUGCCACGUCCGGUUUCAUUCAGGGACUUCAAUUCAGAACCAACUUCAUGGUUUUUGAACUAAUUGGAUAUGAUAAAUGGUACCAAGUUUUCACUUGCAUUCAAGGGACAUAUAUCAUUGGGUUUUUACUUUUAUGGAUAUAUGACUAUGACAUACACGAUUAGAAGCUAAAGGUUGCGGGAGGCAAGCAGUGGGAUAAUGAUCUGCAAGUGGAACUUCUUACUUUUAUCAUAUCCCAUCAGCUCGAAAGUCUUGAUGUUAGUUUUGAAUUGAAGUGCUUGAAUUAGACCAGAUGAAUAGUCAGUAGUCACAACCCUCUACAUAUAUGAGAUCUUCAGGCGUUGAGAAGAUUAAUCUCAAAACUGUAACAGAAAAGUUGGUGGA	......(.((((((.(.((.......(((((((((((((((.(.(((((((..(....((((((.((((((.(((((((...((..((((....((((.(((((.(((((((.(((((((((((((((.(((.(((.(((((((((.((.((.((((((((((((.((((..((((((.((((((((.(((.((..((((((((..((((........))))..)))))))).)).))).......(((((....(((..(.((((.....)))).)..))).....)))))))))))))))))))..)))))))))))))))).)).)).))))))))).))).))).))))))))))))))).))))))).))))).))))....))))...))..))).)))).)))))).)))))).....)..))))))).).)))))))).)))))))..)).))))))).).... 
aly-mir847	GAAUAAAAGUCUCACAUCUUGAUGAAGAGGAAUGGAAAGCCGAGACCCAAAUCAAAACAGAGGCGUCCCCCAAUUAAAAUUGGUAAGUGAUAUCUAUGUCUUGGUUUCGAUCUUGAUCUCGGUCUUUCACUCCUCUUCUUCAUGAUGUAAGAAUUUGUUAUUC	((((((...(((.(((((.(((.((((((((.(((((.(((((((..((((((.((((.(((((((...(((((....)))))............))))))).)))).))).))).))))))).))))).)))))))).))).))))).))).....)))))) 
aly-mir848	UAGUUUCGACUUCCACAGCCUUUAUAUAGCUUGGCAAUCCCAUGUCAAAUAAGGCAAAGAAGAGGAACCCAAGGUAUGUUUCUCAUUUGCCUUCUUUGACAUGGGACUAACAGACUAA	((((((...........(((............)))..((((((((((((.((((((((...(((((((.........))))))).)))))))).)))))))))))).....)))))). 
aly-mir851	AGGGACUGUGGUCUUUGUUUGCGACCCAUACGUAAUCUUUUGUGAGAGACUACGUGUGGGUGGCAAACAAAGACGACAAUCCCU	(((((.(((.((((((((((((.(((((((((((.(((((....))))).))))))))))).)))))))))))).))).))))) 
aly-mir852	GCUCAAAGCUCAGAACAAAGGCGCUUAUCUUAUGGAUAUAUCAAAGAAGAUAAGCGCCUUAGUUCUGAAGAUAAGC	(((...)))(((((((.((((((((((((((...((....))....)))))))))))))).)))))))........ 
aly-mir853	AGGGUAAAGCGUUCCUGCUGCUAUCCUUUUCCUGUUGCAGAAGCCAUUAAAUAUCUUUCUCUUCUGGGUCUCAAGAGCACCUGCGUUAUUAUCAAGUUUUUCAAGUAUCUCUUAAAGAACUUUGGGAUUUCAAGAUCUUCUCCUAGAUGUUUUGGAAGAAGAGUGCCUUUAAUCUAAGAAAUGAUCUUGAGACCCGAAGUUUUUUGAAGAGAAACCUAAAAACUUGAUAUCAACGAAUGUGCUCUUACACGCAACAUUCCUCCUUAUGAUGCAUCAGCAACAACUCCUUGGAAACCAUACCCUUUAGAAAAGAUCAUUGAAAAUGGAGAAUGGAACUUACUCAACGAUAUUUCCUGGCUUCUGCAACCGGAAAGGGGAGCAGCAUGAAACUCU	(((((......(((.(((((((.(((((((((.(((((((((((((..(((((((..(((.((((((((...((((((((...((((..((((((((((((...((.(((((((((((((((((((.((((((((((...((.(((((.....((..........))....))))).))...)))))))))))))))))))))))).))))).))..))))))))))))..))))...))))))))..........((((......((.(((....))).)).......)))).....))))...)))).))).((((...))))(((...........)))...)))))))..))))))))))))).)))))))))))))))).)))))))) 
aly-mir856	GCAUAUGUAAGAGGUGAGACUGUUGGCUUUAAUUCCACCAAUAACUUCAGCUGCGCCAUGAAGAGUAGACAGAAGAUUAUGGCGGUUGAGGGUUUCUUCGUAGAGGUUGAUCGAUCCUUAAUGUCCUGUGGAAUUUAAGUUUCCGAAACUGUUUAUGAGGACAUACAAGAUCGUUCAGUGUCCAAGAAGAAGCCUGAGCCGCUAUAAUCAUCGGUCUAAUCUCUUUAGCAGAUGAUGUUAUUUGUGGUAUAAAACCAACAGUUUUAUCACUCUCACAUAGU	...(((((.(((((((((((((((((.((((...((((.((((((.(((.((((....((((((((((((.((.(((((((((((((..((((((((((...((.(((((.(((((....(((((((...((((...(((((...)))))))))...)))))))....))))).))))).))...)))))))))).))))))))))))).)).)))))..))))))))))).))).)))))).))))..)))).)))))))))))))..)))).))))).. 
aly-mir857	CUCAAAAUUUCUAAUAUUUUCGACUGCUACAACAAACUUUCACCAUACAAAAUAAUCAAGAAAAACACUCAAAAAGAUUGAAUGUGUGAGGUUAGUCUCAUUAACGGAAUUGUGAACAAUUUUGUUAAAAAAUAGUGACUUGGUUUUCAAAUGUAUUUUUUUAAAGAAUAAUGUUUUUUAGCUUUUUAUUAUAUAUCAACAUGAGACCUCAGGUAACAAGGUAAAAGAGACAGAAAAAUAAAAAAAUUUAAUUUUUUCAAGUUUAUAGUUUAUAGUAAAGAAGUUUUUUUUUUUUUUGAAAAAUAUAUUUUAAAACAGUGUCACUAUUUUAAACGGCAAAUGGACAUUUCUAUUAAUGAGAUUAAUGUCGAGCAUUUGGAUUUCUAUUUGAGUACUUUUUGUUUCUAAGUUAUUUUGUAUGUUGAAGGUGUAUUGUAGGAAUCGGAAACAUCAACUCUCAAGAUUUUUAUGAG	(((((((..(((....(((((((.(.((((((...(((((((.(((((((((((((..(((((...(((((((.(((((((((((.(((.((((((((((((((.((((..(((..((..((((((..(((((((((((...(((((.(((((((((((((.((((((...........(((((((((((((((((.(((.(((.((((..(....).))))..........(((((.((((....)))).)))))))).))).)))...)))))).)))))))).....)))))).))))))))))))).)))))...)))))))))))....))))))))..))))))).)))))))))))))).))).))))))))...))).)))))))........)))))..))))))))))))).)))))))...)))))).).)))))))............)))..))).)))) 
aly-mir858	AGAGUGAUUGGAUUCGAUGCUAGGCUUGACAAAGUGAGCAAUCUUAUGUGUUCUCAUCUUUGUUUCGUUGUCUGUUCGACCUUGGUCUCGAUCUCUCCUUAAAACCCUAAUACGUUAUCGUUUAUUUCAUUCAUCUAUCCUUCUUAUGAUCAUCAUACAUGGUAUCGGUUUAUGAUUGAUGGGGUAGAUAGAUGAUCGAAACUUUUGAUUUCUGAGGCUUUUUUUUUUUUUUUAAACAUUUAGUAUACCAGAUAUUACUAGUACACACAUACAUACUGACACGAUAGUCUAUUUGAUGAUUAAGUCUUUACGUUCGUAUACAUACGGAUUUCCCUUUCUUUUGCAUAAAAUCUUAGAUUAUCGUAGGCAUGCGGAUUUACAAUAAGAAAGAUGAUUGUCUAUGGAAUUUAAUGACAUAAAAGGACCUAAAAUAUGGAAACCUUCUUCUGUAAAUCAUUUGAAUGAUUCGGUUGGAGGAAAAUAUAUAUUCCACCGAAUAGGAUAGUUUCAUGUAGAGACUACAUUAUUACAUAUUGACGUGAGAGAGUUCCAUGUAACUAAGCAUGCGCUUGAUGAAUAAACACAUAAGCAAAACCAUGAGCAUAAACAUAUACGUAUACAUGAUUAACUGUGCUGGUAUUGUAUAUGGAUAUCAUGAGAUUGAAAAAGUAGCAAUAACAAAGUAUACAGUUUAUUAGAGUCGUUAAUUCCUAAGGUCAUUUGAUCUCCAUUUUCCCCGUAUCGAUAUGUUUUUUUUUUACUUUUUUUUUUUUUAAUUUUAAUUCUGUGGAGGGAAGUUACAUCUGAUGUAUUAACAAAAAAAGAAAGUUAAAUGUGAUGUUAAAGUCAAAGCCAAGGUCGAGCAGACAACGAAGAUAAGAUGGAACCAGAUCGGGACUACUCCUUUGACAAGUGUUUGCACUGAAUUCAAAAACUUU	.((((..(((((((((.(((.(.(((((.(((((.(((...((((((.(((((.((((((..((((((((((((((((((((((((...........................(..((((....((((..(((((((((..((((((.(..((((((.((.(...).)).))))))).))))))..)))))))))..))))....))))..)...((((((((((((((..........((((((((.(((((...(((.(((......)))........((((((((((((((.(((...(((.......(((((((....)))))))........)))...))).)))...)))))))))))..((((((..(.((((........((((....))))(((((((((..(.((....((((.((........))...))))........((((((....))))))((((.((((...........))))))))(((((..(((((((.....)))))))..)))))..........)).)..))))))))))))).)..))))))(((((.((........)))))))..............((((((((.((.((((..(((((((....((((((((((((((........((..(((.....)))..))........)))))))))..)))))....)))))))....(((((....)))))...........))))))))))))))(((((((((.........................))))))))))))...))))).)))))))).)))))))))))))).....((((......))))..))))))))))))))))))))))))..))))))))).)).)).))))...)))))))).))))).)..))).)))))))))..)))). 
aly-mir859	AGUCGCCGAUGGAUAUAGAUAGAUGUCGAAAUCUCUCCGUUGUAAAAUCAAACAUGAGUAUGAAUUUAACCAUGAAGGGAUAUUUUUGAUUCGUAUACUCAUGUUUGAUUUUACAAUAGAUAGAUAUCGACGCCUAUCUCUUGUUAAACAGAGUGAUU	.((((((....((((.((((((.((((((.((((.((.((((((((((((((((((((((((((((((.((......)).)).....)))))..))))))))))))))))))))))).)).)))).)))))).))))))..)))).....).))))). 
aly-mir860	UCUUUUCUUGGAGAAAUGUCUUGGUCAAAUUCAAUAUAUAUAGUCCAAUCUAUUGAAGUACUAGUACACCAGCUCUAAUAAGCUGAUGUAGGUAAGUAGUUCAAUAGAUUGGACUAUAUAUAUUAAAUUUGACUAAGAGAUAAACUAGAGAAUGAGA	(((((((((......((.(((((((((((((.(((((((((((((((((((((((((.((((..((((.(((((......))))).))))....)))).))))))))))))))))))))))))).))))))))))))).))......))))).)))) 
aly-mir861	AAUGAUGUGUUUGGAGAAAUAUGCAUCAUGGAGUCUGUCUUCUUGAGAAGCAUUUUUGAGUGAGAAUAAUUCUCAUAAAUAAUGAUGGAUAUAUCUUCAAGAACUUCGUU	(((((.((.((((((((.((((.((((((((((.....)))).((((((..((((((....))))))..))))))......)))))).)))).)))))))).)).))))) 
aly-mir862	ACAAUUAUGGAAUGACAAGCAUGUACUGAAACUGAGAGUAUAUGGGCACUGUGUCCAACUGAAAGAGAAAAGACACAAAGUUUCCUUAUAAAUACAGUACAAAUCACAAGUUCAGCCAUCUUAUAUGUACAGUAAUCUUCCAAUAGGUCUAGCAUGUGCUGAAACUGUGUGUUGUGUGUACAAUGUUCUCAUAUACACACAGUUUCAGCACAUGCUGGAUCUACUUGAAGACUACUGUUCUUAUAAGGUACUGAACUUGUUAUCUGUACUGUGUAUAUAUGAGAUCUCUGUAUUCUUGCUCUUUUAGUUUGACACUUUGUUCUCAUAUACACUCGGUUUCAGCACAUGCUUGACUUACUUGCUUGU	...............(((((((((.(((((((((((.(((((((((.((.(((((.(((((((((((..((((.(((.((((((..((((.((((((((((.((.((((((((((..((((((((.(.((((((.(((((...(((((((((((((((((((((((((((((.(((((...........))))))))))))))))))))))))))))))))))...))))).)))))).).)))))))).)))))))))).)).)))))))))).)))).)))).)).)))..)))).))))))))))).)))))...)).))))))))).))))))))))).))))))))).............. 
aly-mir868	GAAUCUGUUGAAGUACCUUUCUCGGCACUUGAGGAUGUCAACUGACCAGCUCUCGUAUUUCAUGUCAUAAUAAUAGUCACACUAGGGUGAUAUAACGAGGAGAGAGUUAUAUCAUCCUAGCGCGAUUGUUUUUAUGACAUGAAAUACGUUUUAGAACUUAAAACACUUUGACCUUCUUAAGUGCUGAUAAUGUUUCUUAAUUAUGUUU	......(((((...((..((.((((((((((((((.(((((.((...((.((((((((((((((((((((.(((((((.(.(((((((((((((((.........))))))))))))))).).))))))).)))))))))))))))))....))).)).....))..))))).)))))))))))))).)).))...)))))....... 
